"az" = (/obj/machinery/atmospherics/pipe/simple/hidden/supply{dir = 4},/obj/machinery/atmospherics/unary/vent_scrubber/on{dir = 8},/turf/simulated/floor/tiled/dark,/area/engineering)
"ch" = (/obj/machinery/atmospherics/pipe/simple/hidden/supply{dir = 4},/obj/machinery/atmospherics/pipe/simple/hidden/scrubbers{dir = 4},/turf/simulated/floor/tiled/dark,/area/engineering)
"ff" = (/obj/structure/cable{icon_state = "4-8"},/obj/structure/catwalk,/obj/machinery/light/small,/turf/simulated/floor/plating,/area/engineering)
"gh" = (/obj/machinery/door/airlock/hatch{id_tag = "toilet"},/obj/machinery/atmospherics/pipe/simple/hidden/supply,/obj/machinery/atmospherics/pipe/simple/hidden/scrubbers,/turf/simulated/floor/tiled/freezer,/area/engineering)
"gH" = (/obj/structure/hygiene/shower{dir = 4},/obj/structure/curtain/shower,/turf/simulated/floor/tiled/freezer,/area/engineering)
"ho" = (/obj/structure/cable,/obj/structure/cable{icon_state = "1-2"},/obj/machinery/power/solar,/turf/simulated/floor/plating,/area/space)
"hM" = (/obj/machinery/portable_atmospherics/canister/air,/obj/machinery/atmospherics/portables_connector{dir = 4},/turf/simulated/floor/plating,/area/engineering)
"ii" = (/obj/structure/cable{icon_state = "4-8"},/obj/structure/catwalk,/turf/simulated/floor/plating,/area/engineering)
"iI" = (/obj/structure/hygiene/sink{pixel_y = 24},/obj/machinery/atmospherics/unary/vent_scrubber/on,/obj/effect/landmark{name = "JoinLateCryo"},/turf/simulated/floor/tiled/white/monotile,/area/engineering)
"jx" = (/obj/machinery/atmospherics/portables_connector{dir = 4},/obj/item/stack/material/steel/fifty,/obj/item/stack/material/plastic/fifty,/obj/item/stack/material/glass/fifty,/obj/item/stack/material/aluminium/fifty,/obj/structure/closet/crate,/turf/simulated/floor/plating,/area/engineering)
"jX" = (/turf/simulated/wall/natural,/area/space)
"lb" = (/obj/machinery/cryopod,/obj/machinery/computer/cryopod{pixel_x = 32},/obj/structure/window/reinforced,/turf/simulated/floor/tiled/white/monotile,/area/engineering)
"nA" = (/obj/machinery/atmospherics/pipe/simple/visible{dir = 10},/turf/simulated/floor/plating,/area/engineering)
"qI" = (/obj/machinery/light/small{dir = 4},/obj/item/storage/toolbox/electrical,/turf/simulated/floor/plating,/area/engineering)
"rc" = (/obj/structure/cable,/obj/machinery/power/solar,/turf/simulated/floor/plating,/area/space)
"rv" = (/obj/structure/bed/padded,/obj/item/bedsheet,/obj/machinery/light_switch/on{pixel_y = 24},/turf/simulated/floor/carpet/blue,/area/engineering)
"rC" = (/obj/structure/bed/padded,/obj/item/bedsheet,/obj/machinery/light/small{dir = 8},/turf/simulated/floor/carpet/blue,/area/engineering)
"rI" = (/obj/effect/floor_decal/industrial/outline/yellow,/obj/machinery/light/small,/obj/machinery/fabricator,/turf/simulated/floor/tiled/dark/monotile,/area/engineering)
"rL" = (/obj/structure/cable{icon_state = "0-2"},/obj/structure/cable{icon_state = "1-2"},/obj/machinery/power/solar,/turf/simulated/floor/plating,/area/space)
"sb" = (/obj/structure/cable{icon_state = "1-8"},/obj/structure/cable{icon_state = "4-8"},/obj/machinery/atmospherics/pipe/manifold/hidden/supply{dir = 8},/obj/machinery/atmospherics/pipe/simple/hidden/scrubbers{dir = 6},/turf/simulated/floor/tiled/dark,/area/engineering)
"tY" = (/obj/machinery/atmospherics/pipe/simple/visible{dir = 9},/obj/item/storage/toolbox/mechanical,/obj/machinery/network/router,/turf/simulated/floor/plating,/area/engineering)
"um" = (/obj/machinery/power/smes/buildable/preset,/obj/structure/cable{icon_state = "0-4"},/turf/simulated/floor/plating,/area/engineering)
"up" = (/obj/effect/floor_decal/industrial/outline/yellow,/obj/machinery/computer/modular/preset/civilian{dir = 1},/turf/simulated/floor/tiled/dark/monotile,/area/engineering)
"ux" = (/obj/structure/hygiene/sink{dir = 4; pixel_x = 16},/obj/item/storage/mirror{pixel_x = 28},/obj/machinery/atmospherics/pipe/simple/hidden/supply,/obj/machinery/atmospherics/unary/vent_scrubber/on{dir = 1},/turf/simulated/floor/tiled/freezer,/area/engineering)
"uO" = (/obj/machinery/power/apc{dir = 4},/obj/structure/cable{icon_state = "0-8"},/obj/structure/table/reinforced,/obj/machinery/cell_charger,/obj/random/powercell,/obj/random/powercell,/obj/random/powercell,/turf/simulated/floor/plating,/area/engineering)
"uU" = (/obj/structure/cable{icon_state = "0-2"},/obj/machinery/power/solar,/turf/simulated/floor/plating,/area/space)
"vB" = (/obj/structure/cable{icon_state = "1-2"},/obj/machinery/atmospherics/unary/vent_pump/on,/turf/simulated/floor/tiled/dark,/area/engineering)
"wq" = (/obj/machinery/atmospherics/pipe/simple/hidden/scrubbers,/turf/simulated/floor/tiled/dark,/area/engineering)
"xb" = (/turf/space,/area/space)
"xh" = (/obj/machinery/cryopod,/obj/machinery/light/small{dir = 4},/turf/simulated/floor/tiled/white/monotile,/area/engineering)
"zd" = (/obj/machinery/power/solar_control,/obj/structure/cable{icon_state = "0-2"},/turf/simulated/floor/tiled/dark/monotile,/area/engineering)
"zU" = (/obj/effect/wallframe_spawn/reinforced,/turf/simulated/floor/plating,/area/engineering)
"At" = (/obj/structure/cable{icon_state = "4-8"},/obj/structure/cable{icon_state = "2-4"},/obj/structure/cable{icon_state = "1-4"},/turf/simulated/floor/plating,/area/space)
"AS" = (/obj/structure/cable{icon_state = "4-8"},/turf/simulated/floor/plating,/area/space)
"Bx" = (/obj/structure/table/rack,/obj/item/clothing/suit/space/void/engineering/prepared,/obj/item/clothing/suit/space/void/engineering/prepared,/obj/item/clothing/suit/space/void/engineering/prepared,/turf/simulated/floor/plating,/area/engineering)
"CF" = (/obj/machinery/atmospherics/pipe/manifold/visible,/turf/simulated/floor/plating,/area/engineering)
"DW" = (/obj/structure/bed/padded,/obj/item/bedsheet,/turf/simulated/floor/carpet/blue,/area/engineering)
"EK" = (/obj/machinery/atmospherics/pipe/simple/hidden/supply,/obj/machinery/atmospherics/pipe/simple/hidden/scrubbers,/turf/simulated/floor/plating,/area/engineering)
"Fd" = (/obj/structure/hygiene/toilet{dir = 4},/obj/machinery/button/alternate/door/bolts{id_tag = "toilet"; name = "hatch lock button"; pixel_y = -24},/turf/simulated/floor/tiled/freezer,/area/engineering)
"GU" = (/obj/structure/table/standard,/turf/simulated/floor/carpet/blue,/area/engineering)
"Iq" = (/obj/machinery/portable_atmospherics/canister/air,/obj/machinery/atmospherics/portables_connector{dir = 4},/obj/item/wrench,/turf/simulated/floor/plating,/area/engineering)
"Jh" = (/obj/machinery/atmospherics/pipe/simple/visible/universal,/obj/item/storage/briefcase/inflatable,/turf/simulated/floor/plating,/area/engineering)
"JG" = (/turf/simulated/wall/r_wall/prepainted,/area/engineering)
"KN" = (/turf/simulated/floor/asteroid,/area/space)
"Lz" = (/obj/structure/inflatable/door,/obj/structure/cable{icon_state = "4-8"},/turf/simulated/floor/plating,/area/engineering)
"LD" = (/obj/machinery/atmospherics/pipe/simple/visible/universal,/obj/machinery/atmospherics/pipe/simple/hidden/scrubbers,/turf/simulated/floor/plating,/area/engineering)
"MU" = (/obj/machinery/door/airlock/external,/obj/structure/cable{icon_state = "4-8"},/obj/structure/catwalk,/turf/simulated/floor/plating,/area/engineering)
"Nb" = (/obj/structure/table/standard,/obj/structure/bedsheetbin,/obj/machinery/light/small,/turf/simulated/floor/carpet,/area/engineering)
"Pp" = (/obj/machinery/portable_atmospherics/canister/empty,/obj/machinery/atmospherics/portables_connector{dir = 4},/turf/simulated/floor/plating,/area/engineering)
"PM" = (/obj/effect/floor_decal/industrial/outline/yellow,/obj/structure/closet/crate/freezer/rations,/turf/simulated/floor/tiled/dark/monotile,/area/engineering)
"Qt" = (/obj/machinery/atmospherics/unary/vent_pump/on{dir = 8},/turf/simulated/floor/tiled/dark,/area/engineering)
"Sf" = (/obj/machinery/atmospherics/pipe/simple/visible{dir = 9},/obj/machinery/atmospherics/pipe/simple/hidden/scrubbers,/turf/simulated/floor/plating,/area/engineering)
"SE" = (/obj/machinery/light/small{dir = 4},/obj/machinery/atmospherics/unary/vent_pump/on{dir = 1},/turf/simulated/floor/tiled/freezer,/area/engineering)
"SG" = (/obj/machinery/sleeper/standard,/turf/simulated/floor/tiled/white/monotile,/area/engineering)
"TK" = (/obj/machinery/power/terminal{dir = 1},/obj/structure/cable{icon_state = "0-2"},/turf/simulated/floor/plating,/area/engineering)
"Vo" = (/obj/machinery/atmospherics/pipe/simple/hidden/supply,/obj/machinery/atmospherics/pipe/simple/hidden/scrubbers,/turf/simulated/floor/tiled/dark,/area/engineering)
"Vq" = (/obj/machinery/atmospherics/pipe/simple/hidden/scrubbers,/obj/effect/landmark{name = "JoinLateCryo"},/turf/simulated/floor/tiled/white/monotile,/area/engineering)
"Xs" = (/obj/structure/table/rack,/obj/item/tank/oxygen,/obj/item/tank/oxygen,/obj/item/tank/oxygen,/turf/simulated/floor/plating,/area/engineering)
"XM" = (/obj/machinery/washing_machine,/turf/simulated/floor/carpet,/area/engineering)
"Yn" = (/obj/structure/closet/crate/medical,/obj/random/medical,/obj/random/medical,/obj/random/medical,/obj/random/medical,/obj/item/roller,/obj/item/storage/firstaid/surgery,/obj/random/firstaid,/obj/random/firstaid,/obj/structure/window/reinforced,/turf/simulated/floor/tiled/white/monotile,/area/engineering)
"Yx" = (/obj/structure/cable{icon_state = "0-4"},/obj/machinery/power/tracker,/turf/simulated/floor/plating,/area/space)
"YI" = (/obj/structure/cable{icon_state = "1-2"},/obj/machinery/door/airlock/hatch/maintenance,/turf/simulated/floor/plating,/area/engineering)
"Zk" = (/obj/machinery/atmospherics/pipe/manifold/hidden/supply{dir = 1},/obj/machinery/atmospherics/pipe/manifold4w/hidden/scrubbers,/turf/simulated/floor/tiled/dark,/area/engineering)
"ZT" = (/obj/structure/cable{icon_state = "1-8"},/obj/machinery/atmospherics/pipe/simple/hidden/supply{dir = 4},/obj/machinery/atmospherics/pipe/simple/hidden/scrubbers{dir = 4},/turf/simulated/floor/tiled/dark,/area/engineering)

(1,1,1) = {"
xbxbxbxbxbxbxbxbxbxbxbxbxbxbxbxbxbxbxbxbxbxbxbxbxbxbxbxbxbxbxbxbxbxbxbxbxbxbxbxbxbxbxbxbxbxbxbxbxbxbxbxbxbxbxbxbxbxbxbxbxbxbxbxbxbxbxbxbxbxbxbxbxbxbxbxbxbxbxbxb
xbxbxbxbxbxbxbxbxbxbxbxbxbxbxbxbxbxbxbxbxbxbxbxbxbxbxbxbxbxbxbxbxbxbxbxbxbxbxbxbxbxbxbxbxbxbxbxbxbxbxbxbxbxbxbxbxbxbxbxbxbxbxbxbxbxbxbxbxbxbxbxbxbxbxbxbxbxbxbxb
xbxbxbxbxbxbxbxbxbxbxbxbxbxbxbxbxbxbxbxbxbxbxbxbxbxbxbxbxbxbxbxbxbxbxbxbxbxbxbxbxbxbxbxbxbxbxbxbxbxbxbxbxbxbxbxbxbxbxbxbxbxbxbxbxbxbxbxbxbxbxbxbxbxbxbxbxbxbxbxb
xbxbxbxbxbxbxbxbxbxbxbxbxbxbxbxbxbxbxbxbxbxbxbxbxbxbxbxbxbxbxbxbxbxbxbxbxbxbxbxbxbxbxbxbxbxbxbxbxbxbxbxbxbxbxbxbxbxbxbxbxbxbxbxbxbxbxbxbxbxbxbxbxbxbxbxbxbxbxbxb
xbxbxbxbxbxbxbxbxbxbxbxbxbxbxbxbxbxbxbxbxbxbxbxbxbxbxbxbxbxbxbxbxbxbxbxbxbxbxbxbxbxbxbxbxbxbxbxbxbxbxbxbxbxbxbxbxbxbxbxbxbxbxbxbxbxbxbxbxbxbxbxbxbxbxbxbxbxbxbxb
xbxbxbxbxbxbxbxbxbxbxbxbxbxbxbxbxbxbxbxbxbxbxbxbxbxbxbxbxbxbxbxbxbxbxbxbxbxbxbxbxbxbxbxbxbxbxbxbxbxbxbxbxbxbxbxbxbxbxbxbxbxbxbxbxbxbxbxbxbxbxbxbxbxbxbxbxbxbxbxb
xbxbxbxbxbxbxbxbxbxbxbxbxbxbxbxbxbxbxbxbxbxbxbxbxbxbxbxbxbxbxbxbxbxbxbxbxbxbxbxbxbxbxbxbxbxbxbxbxbxbxbxbxbxbxbxbxbxbxbxbxbxbxbxbxbxbxbxbxbxbxbxbxbxbxbxbxbxbxbxb
xbxbxbxbxbxbxbxbxbxbxbxbxbxbxbxbxbxbxbxbxbxbxbxbxbxbxbxbxbxbxbxbxbxbxbxbxbxbxbxbxbxbxbxbxbxbxbxbxbxbxbxbxbxbxbxbxbxbxbxbxbxbxbxbxbxbxbxbxbxbxbxbxbxbxbxbxbxbxbxb
xbxbxbxbxbxbxbxbxbxbxbxbxbxbxbxbxbxbxbxbxbxbxbxbxbxbxbxbxbxbxbxbxbxbxbxbxbxbxbxbxbxbxbxbxbxbxbxbxbxbxbxbxbxbxbxbxbxbxbxbxbxbxbxbxbxbxbxbxbxbxbxbxbxbxbxbxbxbxbxb
xbxbxbxbxbxbxbxbxbxbxbxbxbxbxbxbxbxbxbxbxbxbxbxbxbxbxbxbxbxbxbxbxbxbxbxbxbxbxbxbxbxbxbxbxbxbxbxbxbxbxbxbxbxbxbxbxbxbxbxbxbxbxbxbxbxbxbxbxbxbxbxbxbxbxbxbxbxbxbxb
xbxbxbxbxbxbxbxbxbxbxbxbxbxbxbxbxbxbxbxbxbxbxbxbxbxbxbxbxbxbxbxbxbxbxbxbxbxbxbxbxbxbxbxbxbxbxbxbxbxbxbxbxbxbxbxbxbxbxbxbxbxbxbxbxbxbxbxbxbxbxbxbxbxbxbxbxbxbxbxb
xbxbxbxbxbxbxbxbxbxbxbxbxbxbxbxbxbxbxbxbxbxbxbxbxbxbxbxbxbxbxbxbxbxbxbxbxbxbxbxbxbxbxbxbxbxbxbxbxbxbxbxbxbxbxbxbxbxbxbxbxbxbxbxbxbxbxbxbxbxbxbxbxbxbxbxbxbxbxbxb
xbxbxbxbxbxbxbxbxbxbxbxbxbxbxbxbxbxbxbxbxbxbxbxbxbxbxbxbxbxbxbxbxbxbxbxbxbxbxbxbxbxbxbxbxbxbxbxbxbxbxbxbxbxbxbxbxbxbxbxbxbxbxbxbxbxbxbxbxbxbxbxbxbxbxbxbxbxbxbxb
xbxbxbxbxbxbxbxbxbxbxbxbxbxbxbxbxbxbxbxbxbxbxbxbxbxbxbxbxbxbxbxbxbxbxbxbxbxbxbxbxbxbxbxbxbxbxbxbxbxbxbxbxbxbxbxbxbxbxbxbxbxbxbxbxbxbxbxbxbxbxbxbxbxbxbxbxbxbxbxb
xbxbxbxbxbxbxbxbxbxbxbxbxbxbxbxbxbxbxbxbxbxbxbxbxbxbxbxbxbxbxbxbxbxbxbxbxbxbxbxbxbxbxbxbxbxbxbxbxbxbxbxbxbxbxbxbxbxbxbxbxbxbxbxbxbxbxbxbxbxbxbxbxbxbxbxbxbxbxbxb
xbxbxbxbxbxbxbxbxbxbxbxbxbxbxbxbxbxbxbxbxbxbxbxbxbxbxbxbxbxbxbxbxbxbxbxbxbxbxbxbxbxbxbxbxbxbxbxbxbxbxbxbxbxbxbxbxbxbxbxbxbxbxbxbxbxbxbxbxbxbxbxbxbxbxbxbxbxbxbxb
xbxbxbxbxbxbxbxbxbxbxbxbxbxbxbxbxbxbxbxbxbxbxbxbxbxbxbxbxbxbxbxbxbxbxbxbxbxbxbxbxbxbxbxbxbxbxbxbxbxbxbxbxbxbxbxbxbxbxbxbxbxbxbxbxbxbxbxbxbxbxbxbxbxbxbxbxbxbxbxb
xbxbxbxbxbxbxbxbxbxbxbxbxbxbxbxbxbxbxbxbxbxbxbxbxbxbxbxbxbxbxbxbxbxbxbxbxbxbxbxbxbxbxbxbxbxbxbxbxbxbxbxbxbxbxbxbxbxbxbxbxbxbxbxbxbxbxbxbxbxbxbxbxbxbxbxbxbxbxbxb
xbxbxbxbxbxbxbxbxbxbxbxbxbxbxbxbxbxbxbxbxbxbxbxbxbxbxbxbxbxbxbxbxbxbxbxbxbxbxbxbxbxbxbxbxbxbxbxbxbxbxbxbxbxbxbxbxbxbxbxbxbxbxbxbxbxbxbxbxbxbxbxbxbxbxbxbxbxbxbxb
xbxbxbxbxbxbxbxbxbxbxbxbxbxbxbxbxbxbxbxbxbxbxbxbxbxbxbxbxbxbxbxbxbxbxbxbxbxbxbxbxbxbxbxbxbxbxbxbxbxbxbxbxbxbxbxbxbxbxbxbxbxbxbxbxbxbxbxbxbxbxbxbxbxbxbxbxbxbxbxb
xbxbxbxbxbxbxbxbxbxbxbxbxbxbxbxbxbxbxbxbxbxbxbxbxbxbxbxbxbxbxbxbxbxbxbxbxbxbxbxbxbxbxbxbxbxbxbxbxbxbxbxbxbxbxbxbxbxbxbxbxbxbxbxbxbxbxbxbxbxbxbxbxbxbxbxbxbxbxbxb
xbxbxbxbxbxbxbxbxbxbxbxbxbxbxbxbxbxbxbxbxbxbxbxbxbxbxbxbxbxbxbxbxbxbxbxbxbxbxbxbxbxbxbxbxbxbxbxbxbxbxbxbxbxbxbxbxbxbxbxbxbxbxbxbxbxbxbxbxbxbxbxbxbxbxbxbxbxbxbxb
xbxbxbxbxbxbxbxbxbxbxbxbxbxbxbxbxbxbxbxbxbxbxbxbxbxbxbxbxbxbxbxbxbxbxbxbxbxbxbxbxbxbxbxbxbxbxbxbxbxbxbxbxbxbxbxbxbxbxbxbxbxbxbxbxbxbxbxbxbxbxbxbxbxbxbxbxbxbxbxb
xbxbxbxbxbxbxbxbxbxbxbxbxbxbxbxbxbxbxbxbxbxbxbxbxbxbxbxbxbxbxbxbxbxbxbxbxbxbxbxbxbxbxbxbxbxbxbxbxbxbxbxbxbxbxbxbxbxbxbxbxbxbxbxbxbxbxbxbxbxbxbxbxbxbxbxbxbxbxbxb
xbxbxbxbxbxbxbxbxbxbxbxbxbxbxbxbxbxbxbxbxbxbxbxbxbxbxbxbxbxbxbxbxbxbxbxbxbxbxbxbxbxbxbxbxbxbxbxbxbxbxbxbxbxbxbxbxbxbxbxbxbxbxbxbxbxbxbxbxbxbxbxbxbxbxbxbxbxbxbxb
xbxbxbxbxbxbxbxbxbxbxbxbxbxbxbxbxbxbxbxbxbxbxbxbxbxbxbxbxbxbxbxbxbxbxbxbxbxbxbxbxbxbxbxbxbxbxbxbxbxbxbxbxbxbxbxbxbxbxbxbxbxbxbxbxbxbxbxbxbxbxbxbxbxbxbxbxbxbxbxb
xbxbxbxbxbxbxbxbxbxbxbxbxbxbxbxbxbxbxbxbxbxbxbxbxbxbxbxbxbxbxbxbxbxbxbxbxbxbxbxbxbxbxbxbxbxbxbxbxbxbxbxbxbxbxbxbxbxbxbxbxbxbxbxbxbxbxbxbxbxbxbxbxbxbxbxbxbxbxbxb
xbxbxbxbxbxbxbxbxbxbxbxbxbxbxbxbxbxbxbxbxbxbxbxbxbxbxbxbxbxbxbxbxbxbxbxbxbxbxbxbxbxbxbxbxbxbxbxbxbxbxbxbxbxbxbxbxbxbxbxbxbxbxbxbxbxbxbxbxbxbxbxbxbxbxbxbxbxbxbxb
xbxbxbxbxbxbxbxbxbxbxbxbxbxbxbxbxbxbxbxbxbxbxbxbxbxbxbxbxbxbxbxbxbxbxbxbxbxbxbxbxbxbxbxbxbxbxbxbxbxbxbxbxbxbxbxbxbxbxbxbxbxbxbxbxbxbxbxbxbxbxbxbxbxbxbxbxbxbxbxb
xbxbxbxbxbxbxbxbxbxbxbxbxbxbxbxbxbxbxbxbxbxbxbxbxbxbxbxbxbxbxbxbxbxbxbxbxbxbxbxbxbxbxbxbxbxbxbxbxbxbxbxbxbxbxbxbxbxbxbxbxbxbxbxbxbxbxbxbxbxbxbxbxbxbxbxbxbxbxbxb
xbxbxbxbxbxbxbxbxbxbxbxbxbxbxbxbxbxbxbxbxbxbxbxbxbxbxbxbxbxbxbxbxbxbxbxbxbxbxbxbxbxbxbxbxbxbxbxbxbxbxbxbxbxbxbxbxbxbxbxbxbxbxbxbxbxbxbxbxbxbxbxbxbxbxbxbxbxbxbxb
xbxbxbxbxbxbxbxbxbxbxbxbxbxbxbxbxbxbxbxbxbxbxbxbxbxbxbxbxbxbxbxbxbxbxbxbxbxbxbxbxbxbxbxbxbxbxbxbxbxbxbxbxbxbxbxbxbxbxbxbxbxbxbxbxbxbxbxbxbxbxbxbxbxbxbxbxbxbxbxb
xbxbxbxbxbxbxbxbxbxbxbxbxbxbxbxbxbxbxbxbxbxbxbxbxbxbxbxbxbxbxbxbxbxbxbxbxbxbxbxbxbxbxbxbxbxbxbxbxbxbxbxbxbxbxbxbxbxbxbxbxbxbxbxbxbxbxbxbxbxbxbxbxbxbxbxbxbxbxbxb
xbxbxbxbxbxbxbxbxbxbxbxbxbxbxbxbxbxbxbxbxbxbxbxbxbxbxbxbxbxbxbxbxbxbxbxbxbxbxbxbxbxbxbxbxbxbxbxbxbxbxbxbxbxbxbxbxbxbxbxbxbxbxbxbxbxbxbxbxbxbxbxbxbxbxbxbxbxbxbxb
xbxbxbxbxbxbxbxbxbxbxbxbxbxbxbxbxbxbxbxbxbxbxbxbxbxbxbxbxbxbxbxbxbxbxbxbxbxbxbxbxbxbxbxbxbxbxbxbxbxbxbxbxbxbxbxbxbxbxbxbxbxbxbxbxbxbxbxbxbxbxbxbxbxbxbxbxbxbxbxb
xbxbxbxbxbxbxbxbxbxbxbxbxbxbxbxbxbxbxbxbxbxbxbxbxbxbxbxbxbxbxbxbxbxbxbjXjXjXjXKNKNKNKNKNKNKNxbxbxbxbxbxbxbxbxbxbxbxbxbxbxbxbxbxbxbxbxbxbxbxbxbxbxbxbxbxbxbxbxbxb
xbxbxbxbxbxbxbxbxbxbxbxbxbxbxbxbxbxbxbxbxbxbxbxbxbxbxbxbxbxbxbxbxbxbxbjXjXjXjXjXjXjXjXjXjXKNxbxbxbxbxbxbxbxbxbxbxbxbxbxbxbxbxbxbxbxbxbxbxbxbxbxbxbxbxbxbxbxbxbxb
xbxbxbxbxbxbxbxbxbxbxbxbxbxbxbxbxbxbxbxbxbxbxbxbxbxbxbxbxbxbxbxbxbxbjXjXjXJGJGJGJGJGJGJGJGjXxbxbxbxbxbxbxbxbxbxbxbxbxbxbxbxbxbxbxbxbxbxbxbxbxbxbxbxbxbxbxbxbxbxb
xbxbxbxbxbxbxbxbxbxbxbxbxbxbxbxbxbxbxbxbxbxbxbxbxbxbxbxbxbxbxbxbxbxbjXjXjXJGumuOJGSGiIxhJGjXxbxbxbxbxbxbxbxbxbxbxbxbxbxbxbxbxbxbxbxbxbxbxbxbxbxbxbxbxbxbxbxbxbxb
xbxbxbxbxbxbxbxbxbxbxbxbxbxbxbxbxbxbxbxbxbxbxbxbuUxbuUxbuUxbuUxbxbjXjXjXjXJGTKqIJGYnVqlbJGjXxbxbxbxbxbxbxbxbxbxbxbxbxbxbxbxbxbxbxbxbxbxbxbxbxbxbxbxbxbxbxbxbxbxb
xbxbxbxbxbxbxbxbxbxbxbxbxbxbxbxbxbxbxbxbxbxbxbxbrLxbrLxbrLxbrLxbjXjXJGJGJGJGYIJGJGrCwqDWJGJGxbxbxbxbxbxbxbxbxbxbxbxbxbxbxbxbxbxbxbxbxbxbxbxbxbxbxbxbxbxbxbxbxbxb
xbxbxbxbxbxbxbxbxbxbxbxbxbxbxbxbxbxbxbxbxbxbxbxbrLxbrLxbrLxbrLxbJGJGJGBxXsJGvBzdrvGUwqGUDWzUxbxbxbxbxbxbxbxbxbxbxbxbxbxbxbxbxbxbxbxbxbxbxbxbxbxbxbxbxbxbxbxbxbxb
xbxbxbxbxbxbxbxbxbxbxbxbxbxbxbxbxbxbxbxbxbxbYxASAtASAtASAtASAtASLzLzMUffiiMUsbZTchchZkazQtzUxbxbxbxbxbxbxbxbxbxbxbxbxbxbxbxbxbxbxbxbxbxbxbxbxbxbxbxbxbxbxbxbxbxb
xbxbxbxbxbxbxbxbxbxbxbxbxbxbxbxbxbxbxbxbxbxbxbxbhoxbhoxbhoxbhoxbJGJGJGJGJGJGVoPMrIupVoXMNbzUxbxbxbxbxbxbxbxbxbxbxbxbxbxbxbxbxbxbxbxbxbxbxbxbxbxbxbxbxbxbxbxbxbxb
xbxbxbxbxbxbxbxbxbxbxbxbxbxbxbxbxbxbxbxbxbxbxbxbhoxbhoxbhoxbhoxbKNjXjXjXJGJGghJGJGJGEKJGJGJGxbxbxbxbxbxbxbxbxbxbxbxbxbxbxbxbxbxbxbxbxbxbxbxbxbxbxbxbxbxbxbxbxbxb
xbxbxbxbxbxbxbxbxbxbxbxbxbxbxbxbxbxbxbxbxbxbxbxbrcxbrcxbrcxbrcxbKNjXjXjXJGgHuxJGIqnALDJGjXjXxbxbxbxbxbxbxbxbxbxbxbxbxbxbxbxbxbxbxbxbxbxbxbxbxbxbxbxbxbxbxbxbxbxb
xbxbxbxbxbxbxbxbxbxbxbxbxbxbxbxbxbxbxbxbxbxbxbxbxbxbxbxbxbxbxbxbKNjXjXjXJGFdSEJGhMCFSfJGjXjXxbxbxbxbxbxbxbxbxbxbxbxbxbxbxbxbxbxbxbxbxbxbxbxbxbxbxbxbxbxbxbxbxbxb
xbxbxbxbxbxbxbxbxbxbxbxbxbxbxbxbxbxbxbxbxbxbxbxbxbxbxbxbxbxbxbxbKNjXjXjXJGJGJGJGPpnAJhJGjXxbxbxbxbxbxbxbxbxbxbxbxbxbxbxbxbxbxbxbxbxbxbxbxbxbxbxbxbxbxbxbxbxbxbxb
xbxbxbxbxbxbxbxbxbxbxbxbxbxbxbxbxbxbxbxbxbxbxbxbxbxbxbxbxbxbxbxbKNjXjXjXjXjXjXJGjxCFtYJGjXxbxbxbxbxbxbxbxbxbxbxbxbxbxbxbxbxbxbxbxbxbxbxbxbxbxbxbxbxbxbxbxbxbxbxb
xbxbxbxbxbxbxbxbxbxbxbxbxbxbxbxbxbxbxbxbxbxbxbxbxbxbxbxbxbxbxbxbKNKNjXjXjXjXjXJGJGJGJGJGjXxbxbxbxbxbxbxbxbxbxbxbxbxbxbxbxbxbxbxbxbxbxbxbxbxbxbxbxbxbxbxbxbxbxbxb
xbxbxbxbxbxbxbxbxbxbxbxbxbxbxbxbxbxbxbxbxbxbxbxbxbxbxbxbxbxbxbxbxbKNKNKNKNKNjXjXjXjXjXjXjXxbxbxbxbxbxbxbxbxbxbxbxbxbxbxbxbxbxbxbxbxbxbxbxbxbxbxbxbxbxbxbxbxbxbxb
xbxbxbxbxbxbxbxbxbxbxbxbxbxbxbxbxbxbxbxbxbxbxbxbxbxbxbxbxbxbxbxbxbxbxbKNKNKNKNKNjXjXjXjXjXxbxbxbxbxbxbxbxbxbxbxbxbxbxbxbxbxbxbxbxbxbxbxbxbxbxbxbxbxbxbxbxbxbxbxb
xbxbxbxbxbxbxbxbxbxbxbxbxbxbxbxbxbxbxbxbxbxbxbxbxbxbxbxbxbxbxbxbxbxbxbxbxbKNKNKNKNKNKNKNjXxbxbxbxbxbxbxbxbxbxbxbxbxbxbxbxbxbxbxbxbxbxbxbxbxbxbxbxbxbxbxbxbxbxbxb
xbxbxbxbxbxbxbxbxbxbxbxbxbxbxbxbxbxbxbxbxbxbxbxbxbxbxbxbxbxbxbxbxbxbxbxbxbxbxbxbxbxbxbxbxbxbxbxbxbxbxbxbxbxbxbxbxbxbxbxbxbxbxbxbxbxbxbxbxbxbxbxbxbxbxbxbxbxbxbxb
xbxbxbxbxbxbxbxbxbxbxbxbxbxbxbxbxbxbxbxbxbxbxbxbxbxbxbxbxbxbxbxbxbxbxbxbxbxbxbxbxbxbxbxbxbxbxbxbxbxbxbxbxbxbxbxbxbxbxbxbxbxbxbxbxbxbxbxbxbxbxbxbxbxbxbxbxbxbxbxb
xbxbxbxbxbxbxbxbxbxbxbxbxbxbxbxbxbxbxbxbxbxbxbxbxbxbxbxbxbxbxbxbxbxbxbxbxbxbxbxbxbxbxbxbxbxbxbxbxbxbxbxbxbxbxbxbxbxbxbxbxbxbxbxbxbxbxbxbxbxbxbxbxbxbxbxbxbxbxbxb
xbxbxbxbxbxbxbxbxbxbxbxbxbxbxbxbxbxbxbxbxbxbxbxbxbxbxbxbxbxbxbxbxbxbxbxbxbxbxbxbxbxbxbxbxbxbxbxbxbxbxbxbxbxbxbxbxbxbxbxbxbxbxbxbxbxbxbxbxbxbxbxbxbxbxbxbxbxbxbxb
xbxbxbxbxbxbxbxbxbxbxbxbxbxbxbxbxbxbxbxbxbxbxbxbxbxbxbxbxbxbxbxbxbxbxbxbxbxbxbxbxbxbxbxbxbxbxbxbxbxbxbxbxbxbxbxbxbxbxbxbxbxbxbxbxbxbxbxbxbxbxbxbxbxbxbxbxbxbxbxb
xbxbxbxbxbxbxbxbxbxbxbxbxbxbxbxbxbxbxbxbxbxbxbxbxbxbxbxbxbxbxbxbxbxbxbxbxbxbxbxbxbxbxbxbxbxbxbxbxbxbxbxbxbxbxbxbxbxbxbxbxbxbxbxbxbxbxbxbxbxbxbxbxbxbxbxbxbxbxbxb
xbxbxbxbxbxbxbxbxbxbxbxbxbxbxbxbxbxbxbxbxbxbxbxbxbxbxbxbxbxbxbxbxbxbxbxbxbxbxbxbxbxbxbxbxbxbxbxbxbxbxbxbxbxbxbxbxbxbxbxbxbxbxbxbxbxbxbxbxbxbxbxbxbxbxbxbxbxbxbxb
xbxbxbxbxbxbxbxbxbxbxbxbxbxbxbxbxbxbxbxbxbxbxbxbxbxbxbxbxbxbxbxbxbxbxbxbxbxbxbxbxbxbxbxbxbxbxbxbxbxbxbxbxbxbxbxbxbxbxbxbxbxbxbxbxbxbxbxbxbxbxbxbxbxbxbxbxbxbxbxb
xbxbxbxbxbxbxbxbxbxbxbxbxbxbxbxbxbxbxbxbxbxbxbxbxbxbxbxbxbxbxbxbxbxbxbxbxbxbxbxbxbxbxbxbxbxbxbxbxbxbxbxbxbxbxbxbxbxbxbxbxbxbxbxbxbxbxbxbxbxbxbxbxbxbxbxbxbxbxbxb
xbxbxbxbxbxbxbxbxbxbxbxbxbxbxbxbxbxbxbxbxbxbxbxbxbxbxbxbxbxbxbxbxbxbxbxbxbxbxbxbxbxbxbxbxbxbxbxbxbxbxbxbxbxbxbxbxbxbxbxbxbxbxbxbxbxbxbxbxbxbxbxbxbxbxbxbxbxbxbxb
xbxbxbxbxbxbxbxbxbxbxbxbxbxbxbxbxbxbxbxbxbxbxbxbxbxbxbxbxbxbxbxbxbxbxbxbxbxbxbxbxbxbxbxbxbxbxbxbxbxbxbxbxbxbxbxbxbxbxbxbxbxbxbxbxbxbxbxbxbxbxbxbxbxbxbxbxbxbxbxb
xbxbxbxbxbxbxbxbxbxbxbxbxbxbxbxbxbxbxbxbxbxbxbxbxbxbxbxbxbxbxbxbxbxbxbxbxbxbxbxbxbxbxbxbxbxbxbxbxbxbxbxbxbxbxbxbxbxbxbxbxbxbxbxbxbxbxbxbxbxbxbxbxbxbxbxbxbxbxbxb
xbxbxbxbxbxbxbxbxbxbxbxbxbxbxbxbxbxbxbxbxbxbxbxbxbxbxbxbxbxbxbxbxbxbxbxbxbxbxbxbxbxbxbxbxbxbxbxbxbxbxbxbxbxbxbxbxbxbxbxbxbxbxbxbxbxbxbxbxbxbxbxbxbxbxbxbxbxbxbxb
xbxbxbxbxbxbxbxbxbxbxbxbxbxbxbxbxbxbxbxbxbxbxbxbxbxbxbxbxbxbxbxbxbxbxbxbxbxbxbxbxbxbxbxbxbxbxbxbxbxbxbxbxbxbxbxbxbxbxbxbxbxbxbxbxbxbxbxbxbxbxbxbxbxbxbxbxbxbxbxb
xbxbxbxbxbxbxbxbxbxbxbxbxbxbxbxbxbxbxbxbxbxbxbxbxbxbxbxbxbxbxbxbxbxbxbxbxbxbxbxbxbxbxbxbxbxbxbxbxbxbxbxbxbxbxbxbxbxbxbxbxbxbxbxbxbxbxbxbxbxbxbxbxbxbxbxbxbxbxbxb
xbxbxbxbxbxbxbxbxbxbxbxbxbxbxbxbxbxbxbxbxbxbxbxbxbxbxbxbxbxbxbxbxbxbxbxbxbxbxbxbxbxbxbxbxbxbxbxbxbxbxbxbxbxbxbxbxbxbxbxbxbxbxbxbxbxbxbxbxbxbxbxbxbxbxbxbxbxbxbxb
xbxbxbxbxbxbxbxbxbxbxbxbxbxbxbxbxbxbxbxbxbxbxbxbxbxbxbxbxbxbxbxbxbxbxbxbxbxbxbxbxbxbxbxbxbxbxbxbxbxbxbxbxbxbxbxbxbxbxbxbxbxbxbxbxbxbxbxbxbxbxbxbxbxbxbxbxbxbxbxb
xbxbxbxbxbxbxbxbxbxbxbxbxbxbxbxbxbxbxbxbxbxbxbxbxbxbxbxbxbxbxbxbxbxbxbxbxbxbxbxbxbxbxbxbxbxbxbxbxbxbxbxbxbxbxbxbxbxbxbxbxbxbxbxbxbxbxbxbxbxbxbxbxbxbxbxbxbxbxbxb
xbxbxbxbxbxbxbxbxbxbxbxbxbxbxbxbxbxbxbxbxbxbxbxbxbxbxbxbxbxbxbxbxbxbxbxbxbxbxbxbxbxbxbxbxbxbxbxbxbxbxbxbxbxbxbxbxbxbxbxbxbxbxbxbxbxbxbxbxbxbxbxbxbxbxbxbxbxbxbxb
xbxbxbxbxbxbxbxbxbxbxbxbxbxbxbxbxbxbxbxbxbxbxbxbxbxbxbxbxbxbxbxbxbxbxbxbxbxbxbxbxbxbxbxbxbxbxbxbxbxbxbxbxbxbxbxbxbxbxbxbxbxbxbxbxbxbxbxbxbxbxbxbxbxbxbxbxbxbxbxb
xbxbxbxbxbxbxbxbxbxbxbxbxbxbxbxbxbxbxbxbxbxbxbxbxbxbxbxbxbxbxbxbxbxbxbxbxbxbxbxbxbxbxbxbxbxbxbxbxbxbxbxbxbxbxbxbxbxbxbxbxbxbxbxbxbxbxbxbxbxbxbxbxbxbxbxbxbxbxbxb
xbxbxbxbxbxbxbxbxbxbxbxbxbxbxbxbxbxbxbxbxbxbxbxbxbxbxbxbxbxbxbxbxbxbxbxbxbxbxbxbxbxbxbxbxbxbxbxbxbxbxbxbxbxbxbxbxbxbxbxbxbxbxbxbxbxbxbxbxbxbxbxbxbxbxbxbxbxbxbxb
xbxbxbxbxbxbxbxbxbxbxbxbxbxbxbxbxbxbxbxbxbxbxbxbxbxbxbxbxbxbxbxbxbxbxbxbxbxbxbxbxbxbxbxbxbxbxbxbxbxbxbxbxbxbxbxbxbxbxbxbxbxbxbxbxbxbxbxbxbxbxbxbxbxbxbxbxbxbxbxb
xbxbxbxbxbxbxbxbxbxbxbxbxbxbxbxbxbxbxbxbxbxbxbxbxbxbxbxbxbxbxbxbxbxbxbxbxbxbxbxbxbxbxbxbxbxbxbxbxbxbxbxbxbxbxbxbxbxbxbxbxbxbxbxbxbxbxbxbxbxbxbxbxbxbxbxbxbxbxbxb
xbxbxbxbxbxbxbxbxbxbxbxbxbxbxbxbxbxbxbxbxbxbxbxbxbxbxbxbxbxbxbxbxbxbxbxbxbxbxbxbxbxbxbxbxbxbxbxbxbxbxbxbxbxbxbxbxbxbxbxbxbxbxbxbxbxbxbxbxbxbxbxbxbxbxbxbxbxbxbxb
xbxbxbxbxbxbxbxbxbxbxbxbxbxbxbxbxbxbxbxbxbxbxbxbxbxbxbxbxbxbxbxbxbxbxbxbxbxbxbxbxbxbxbxbxbxbxbxbxbxbxbxbxbxbxbxbxbxbxbxbxbxbxbxbxbxbxbxbxbxbxbxbxbxbxbxbxbxbxbxb
xbxbxbxbxbxbxbxbxbxbxbxbxbxbxbxbxbxbxbxbxbxbxbxbxbxbxbxbxbxbxbxbxbxbxbxbxbxbxbxbxbxbxbxbxbxbxbxbxbxbxbxbxbxbxbxbxbxbxbxbxbxbxbxbxbxbxbxbxbxbxbxbxbxbxbxbxbxbxbxb
"}
