"ax" = (/obj/structure/lattice,/turf/simulated/open,/area/space)
"RC" = (/obj/structure/railing/mapped{dir = 8},/turf/simulated/floor/plating,/area/space)
"RM" = (/turf/simulated/floor/tiled/techmaint,/area/space)
"SP" = (/turf/simulated/floor/plating,/area/space)
"Um" = (/obj/structure/railing/mapped{dir = 4},/turf/simulated/floor/plating,/area/space)
"Vi" = (/turf/space/sky,/area/space)
"WH" = (/obj/structure/railing/mapped{dir = 1},/turf/simulated/floor/plating,/area/space)
"Ys" = (/turf/simulated/open,/area/space)
"Zj" = (/obj/structure/railing/mapped,/turf/simulated/floor/plating,/area/space)
"ZR" = (/turf/simulated/wall/r_wall/prepainted,/area/space)

(1,1,1) = {"
ViViViViViViViViViViViViViViViViViViViViViViViViViViViViViViViViViViViViViViViViViViViViViViViViViViViViViViViViViViViViViViViViViViViViViViViViViViViViViViViVi
ViViViViViViViViViViViViViViViViViViViViViViViViViViViViViViViViViViViViViViViViViViViViViViViViViViViViViViViViViViViViViViViViViViViViViViViViViViViViViViViVi
ViViViViViViViViViViViViViViViViViViViViViViViViViViViViViViViViViViViViViViViViViViViViViViViViViViViViViViViViViViViViViViViViViViViViViViViViViViViViViViViVi
ViViViViViViViViViViViViViViViViViViViViViViViViViViViViViViViViViViViViViViViViViViViViViViViViViViViViViViViViViViViViViViViViViViViViViViViViViViViViViViViVi
ViViViViViViViViViViViViViViViViViViViViViViViViViViViViViViViViViViViViViViViViViViViViViViViViViViViViViViViViViViViViViViViViViViViViViViViViViViViViViViViVi
ViViViViViViViViViViViViViViViViViViViViViViViViViViViViViViViViViViViViViViViViViViViViViViViViViViViViViViViViViViViViViViViViViViViViViViViViViViViViViViViVi
ViViViViViViViViViViViViViViViViViViViViViViViViViViViViViViViViViViViViViViViViViViViViViViViViViViViViViViViViViViViViViViViViViViViViViViViViViViViViViViViVi
ViViViViViViViViViViViViViViViViViViViViViViViViViViViViViViViViViViViViViViViViViViViViViViViViViViViViViViViViViViViViViViViViViViViViViViViViViViViViViViViVi
ViViViViViViViViViViViViViViViViViViViViViViViViViViViViViViViViViViViViViViViViViViViViViViViViViViViViViViViViViViViViViViViViViViViViViViViViViViViViViViViVi
ViViViViViViViViViViViViViViViViViViViViViViViViViViViViViViViViViViViViViViViViViViViViViViViViViViViViViViViViViViViViViViViViViViViViViViViViViViViViViViViVi
ViViViViViViViViViViViViViViViViViViViViViViViViViViViViViViViViViViViViViViViViViViViViViViViViViViViViViViViViViViViViViViViViViViViViViViViViViViViViViViViVi
ViViViViViViViViViViViViViViViViViViViViViViViViViViViViViViViViViViViViViViViViViViViViViViViViViViViViViViViViViViViViViViViViViViViViViViViViViViViViViViViVi
ViViViViViViViViViViViViViViViViViViViViViViViViViViViViViViViViViViViViViViViViViViViViViViViViViViViViViViViViViViViViViViViViViViViViViViViViViViViViViViViVi
ViViViViViViViViViViViViViViViViViViViViViViViViViViViViViViViViViViViViViViViViViViViViViViViViViViViViViViViViViViViViViViViViViViViViViViViViViViViViViViViVi
ViViViViViViViViViViViViViViViViViViViViViViViViViViViViViViViViViViViViViViViViViViViViViViViViViViViViViViViViViViViViViViViViViViViViViViViViViViViViViViViVi
ViViViViViViViViViViViViViViViViViViViViViViViViViViViViViViViViViViViViViViViViViViViViViViViViViViViViViViViViViViViViViViViViViViViViViViViViViViViViViViViVi
ViViViViViViViViViViViViViViViViViViViViViViViViViViViViViViViViViViViViViViViViViViViViViViViViViViViViViViViViViViViViViViViViViViViViViViViViViViViViViViViVi
ViViViViViViViViViViViViViViViViViViViViViViViViViViViViViViViViViViViViViViViViViViViViViViViViViViViViViViViViViViViViViViViViViViViViViViViViViViViViViViViVi
ViViViViViViViViViViViViViViViViViViViViViViViViViViViViViViViViViViViViViViViViViViViViViViViViViViViViViViViViViViViViViViViViViViViViViViViViViViViViViViViVi
ViViViViViViViViViViViViViViViViViViViViViViViViViViViViViViViViViViViViViViViViViViViViViViViViViViViViViViViViViViViViViViViViViViViViViViViViViViViViViViViVi
ViViViViViViViViViViViViViViViViViViViViViViViViViViViViViViViViViViViViViViViViViViViViViViViViViViViViViViViViViViViViViViViViViViViViViViViViViViViViViViViVi
ViViViViViViViViViViViViViViViViViViViViViViViViViViViViViViViViViViViViViViViViViViViViViViViViViViViViViViViViViViViViViViViViViViViViViViViViViViViViViViViVi
ViViViViViViViViViViViViViViViViViViViViViViViViViViViViViViViViViViViViViViViViViViViViViViViViViViViViViViViViViViViViViViViViViViViViViViViViViViViViViViViVi
ViViViViViViViViViViViViViViViViViViViViViViViViViViViViViViViViViViViViViViViViViViViViViViViViViViViViViViViViViViViViViViViViViViViViViViViViViViViViViViViVi
ViViViViViViViViViViViViViViViViViViViViViViViViViViViViViViViViViViViViViViViViViViViViViViViViViViViViViViViViViViViViViViViViViViViViViViViViViViViViViViViVi
ViViViViViViViViViViViViViViViViViViViViViViViViViViViViViViViViViViViViViViViViViViViViViViViViViViViViViViViViViViViViViViViViViViViViViViViViViViViViViViViVi
ViViViViViViViViViViViViViViViViViViViViViViViViViViViViViViViViViViViViViViViViViViViViViViViViViViViViViViViViViViViViViViViViViViViViViViViViViViViViViViViVi
ViViViViViViViViViViViViViViViViViViViViViViViViViViViViViViViViViViViViViViViViViViViViViViViViViViViViViViViViViViViViViViViViViViViViViViViViViViViViViViViVi
ViViViViViViViViViViViViViViViViViViViViViViViViViViViViViViViViViViViViViViViViViViViViViViViViViViViViViViViViViViViViViViViViViViViViViViViViViViViViViViViVi
ViViViViViViViViViViViViViViViViViViViViViViViViViViViViViViViViViViViViViViViViViViViViViViViViViViViViViViViViViViViViViViViViViViViViViViViViViViViViViViViVi
ViViViViViViViViViViViViViViViViViViViViViViViViViViViViViViViViViViViViViViViViViViViViViViViViViViViViViViViViViViViViViViViViViViViViViViViViViViViViViViViVi
ViViViViViViViViViViViViViViViViViViViViViViViViViViViViViViViViViViViViViViViViViViViViViViViViViViViViViViViViViViViViViViViViViViViViViViViViViViViViViViViVi
ViViViViViViViViViViViViViViViViViViViViViViViViViViViViViViViViViViViViViViViViViViViViViViViViViViViViViViViViViViViViViViViViViViViViViViViViViViViViViViViVi
ViViViViViViViViViViViViViViViViViViViViViViViViViViViViViViViViViViViViViViViViViViViViViViViViViViViViViViViViViViViViViViViViViViViViViViViViViViViViViViViVi
ViViViViViViViViViViViViViViViViViViViViViViViViViViViViViViViViViViViViViViViViViViViViViViViViViViViViViViViViViViViViViViViViViViViViViViViViViViViViViViViVi
ViViViViViViViViViViViViViViViViViViViViViViViViViViViViViViViViViViViViZRZRZRZRZRZRZRViViViViViViViViViViViViViViViViViViViViViViViViViViViViViViViViViViViViVi
ViViViViViViViViViViViViViViViViViViViViViViViViViViViViViViViViViViViZRZRSPZjZjZjSPZRZRViViViViViViViViViViViViViViViViViViViViViViViViViViViViViViViViViViViVi
ViViViViViViViViViViViViViViViViViViViViViViViViViViViViViViViViViViViZRRMUmYsYsYsRCRMZRViViViViViViViViViViViViViViViViViViViViViViViViViViViViViViViViViViViVi
ViViViViViViViViViViViViViViViViViViViViViViViViViViViViViViViViViViViZRRMUmYsYsYsRCRMZRViViViViViViViViViViViViViViViViViViViViViViViViViViViViViViViViViViViVi
ViViViViViViViViViViViViViViViViViViViViViViViViViViViViViViViViViViViZRRMUmYsaxYsRCRMZRViViViViViViViViViViViViViViViViViViViViViViViViViViViViViViViViViViViVi
ViViViViViViViViViViViViViViViViViViViViViViViViViViViViViViViViViViViZRRMUmYsaxYsRCRMZRViViViViViViViViViViViViViViViViViViViViViViViViViViViViViViViViViViViVi
ViViViViViViViViViViViViViViViViViViViViViViViViViViViViViViViViViViViZRRMUmYsaxYsRCRMZRViViViViViViViViViViViViViViViViViViViViViViViViViViViViViViViViViViViVi
ViViViViViViViViViViViViViViViViViViViViViViViViViViViViZRZRZRZRZRZRZRZRZRSPWHSPWHSPZRZRZRZRZRZRZRZRZRViViViViViViViViViViViViViViViViViViViViViViViViViViViViVi
ViViViViViViViViViViViViViViViViViViViViViViViViViViViZRZRSPZjZjZjSPZRZRZRZRZRSPZRZRZRZRZRSPZjZjZjSPZRZRViViViViViViViViViViViViViViViViViViViViViViViViViViViVi
ViViViViViViViViViViViViViViViViViViViViViViViViViViViZRRMUmYsYsYsRCRMZRSPSPSPSPSPSPSPZRRMUmYsYsYsRCRMZRViViViViViViViViViViViViViViViViViViViViViViViViViViViVi
ViViViViViViViViViViViViViViViViViViViViViViViViViViViZRRMUmYsYsYsRCRMZRSPSPSPSPSPSPSPZRRMUmYsYsYsRCRMZRViViViViViViViViViViViViViViViViViViViViViViViViViViViVi
ViViViViViViViViViViViViViViViViViViViViViViViViViViViZRRMUmYsYsYsRCRMSPSPSPSPSPSPSPSPSPRMUmYsYsYsRCRMZRViViViViViViViViViViViViViViViViViViViViViViViViViViViVi
ViViViViViViViViViViViViViViViViViViViViViViViViViViViZRRMUmYsYsYsRCRMZRSPSPSPSPSPSPSPZRRMUmYsYsYsRCRMZRViViViViViViViViViViViViViViViViViViViViViViViViViViViVi
ViViViViViViViViViViViViViViViViViViViViViViViViViViViZRRMUmYsYsYsRCRMZRSPSPSPSPSPSPSPZRRMUmYsYsYsRCRMZRViViViViViViViViViViViViViViViViViViViViViViViViViViViVi
ViViViViViViViViViViViViViViViViViViViViViViViViViViViZRZRSPWHSPWHSPZRZRZRZRZRSPZRZRZRZRZRSPWHSPWHSPZRZRViViViViViViViViViViViViViViViViViViViViViViViViViViViVi
ViViViViViViViViViViViViViViViViViViViViViViViViViViViViZRZRZRZRZRZRZRZRZRSPZjZjZjSPZRZRZRZRZRZRZRZRZRViViViViViViViViViViViViViViViViViViViViViViViViViViViViVi
ViViViViViViViViViViViViViViViViViViViViViViViViViViViViViViViViViViViZRRMUmYsYsYsRCRMZRViViViViViViViViViViViViViViViViViViViViViViViViViViViViViViViViViViViVi
ViViViViViViViViViViViViViViViViViViViViViViViViViViViViViViViViViViViZRRMUmYsYsYsRCRMZRViViViViViViViViViViViViViViViViViViViViViViViViViViViViViViViViViViViVi
ViViViViViViViViViViViViViViViViViViViViViViViViViViViViViViViViViViViZRRMUmYsYsYsRCRMZRViViViViViViViViViViViViViViViViViViViViViViViViViViViViViViViViViViViVi
ViViViViViViViViViViViViViViViViViViViViViViViViViViViViViViViViViViViZRRMUmYsYsYsRCRMZRViViViViViViViViViViViViViViViViViViViViViViViViViViViViViViViViViViViVi
ViViViViViViViViViViViViViViViViViViViViViViViViViViViViViViViViViViViZRRMUmYsYsYsRCRMZRViViViViViViViViViViViViViViViViViViViViViViViViViViViViViViViViViViViVi
ViViViViViViViViViViViViViViViViViViViViViViViViViViViViViViViViViViViZRZRSPWHSPWHSPZRZRViViViViViViViViViViViViViViViViViViViViViViViViViViViViViViViViViViViVi
ViViViViViViViViViViViViViViViViViViViViViViViViViViViViViViViViViViViViZRZRZRSPZRZRZRViViViViViViViViViViViViViViViViViViViViViViViViViViViViViViViViViViViViVi
ViViViViViViViViViViViViViViViViViViViViViViViViViViViViViViViViViViViViViViViViViViViViViViViViViViViViViViViViViViViViViViViViViViViViViViViViViViViViViViViVi
ViViViViViViViViViViViViViViViViViViViViViViViViViViViViViViViViViViViViViViViViViViViViViViViViViViViViViViViViViViViViViViViViViViViViViViViViViViViViViViViVi
ViViViViViViViViViViViViViViViViViViViViViViViViViViViViViViViViViViViViViViViViViViViViViViViViViViViViViViViViViViViViViViViViViViViViViViViViViViViViViViViVi
ViViViViViViViViViViViViViViViViViViViViViViViViViViViViViViViViViViViViViViViViViViViViViViViViViViViViViViViViViViViViViViViViViViViViViViViViViViViViViViViVi
ViViViViViViViViViViViViViViViViViViViViViViViViViViViViViViViViViViViViViViViViViViViViViViViViViViViViViViViViViViViViViViViViViViViViViViViViViViViViViViViVi
ViViViViViViViViViViViViViViViViViViViViViViViViViViViViViViViViViViViViViViViViViViViViViViViViViViViViViViViViViViViViViViViViViViViViViViViViViViViViViViViVi
ViViViViViViViViViViViViViViViViViViViViViViViViViViViViViViViViViViViViViViViViViViViViViViViViViViViViViViViViViViViViViViViViViViViViViViViViViViViViViViViVi
ViViViViViViViViViViViViViViViViViViViViViViViViViViViViViViViViViViViViViViViViViViViViViViViViViViViViViViViViViViViViViViViViViViViViViViViViViViViViViViViVi
ViViViViViViViViViViViViViViViViViViViViViViViViViViViViViViViViViViViViViViViViViViViViViViViViViViViViViViViViViViViViViViViViViViViViViViViViViViViViViViViVi
ViViViViViViViViViViViViViViViViViViViViViViViViViViViViViViViViViViViViViViViViViViViViViViViViViViViViViViViViViViViViViViViViViViViViViViViViViViViViViViViVi
ViViViViViViViViViViViViViViViViViViViViViViViViViViViViViViViViViViViViViViViViViViViViViViViViViViViViViViViViViViViViViViViViViViViViViViViViViViViViViViViVi
ViViViViViViViViViViViViViViViViViViViViViViViViViViViViViViViViViViViViViViViViViViViViViViViViViViViViViViViViViViViViViViViViViViViViViViViViViViViViViViViVi
ViViViViViViViViViViViViViViViViViViViViViViViViViViViViViViViViViViViViViViViViViViViViViViViViViViViViViViViViViViViViViViViViViViViViViViViViViViViViViViViVi
ViViViViViViViViViViViViViViViViViViViViViViViViViViViViViViViViViViViViViViViViViViViViViViViViViViViViViViViViViViViViViViViViViViViViViViViViViViViViViViViVi
ViViViViViViViViViViViViViViViViViViViViViViViViViViViViViViViViViViViViViViViViViViViViViViViViViViViViViViViViViViViViViViViViViViViViViViViViViViViViViViViVi
ViViViViViViViViViViViViViViViViViViViViViViViViViViViViViViViViViViViViViViViViViViViViViViViViViViViViViViViViViViViViViViViViViViViViViViViViViViViViViViViVi
ViViViViViViViViViViViViViViViViViViViViViViViViViViViViViViViViViViViViViViViViViViViViViViViViViViViViViViViViViViViViViViViViViViViViViViViViViViViViViViViVi
ViViViViViViViViViViViViViViViViViViViViViViViViViViViViViViViViViViViViViViViViViViViViViViViViViViViViViViViViViViViViViViViViViViViViViViViViViViViViViViViVi
ViViViViViViViViViViViViViViViViViViViViViViViViViViViViViViViViViViViViViViViViViViViViViViViViViViViViViViViViViViViViViViViViViViViViViViViViViViViViViViViVi
ViViViViViViViViViViViViViViViViViViViViViViViViViViViViViViViViViViViViViViViViViViViViViViViViViViViViViViViViViViViViViViViViViViViViViViViViViViViViViViViVi
ViViViViViViViViViViViViViViViViViViViViViViViViViViViViViViViViViViViViViViViViViViViViViViViViViViViViViViViViViViViViViViViViViViViViViViViViViViViViViViViVi
ViViViViViViViViViViViViViViViViViViViViViViViViViViViViViViViViViViViViViViViViViViViViViViViViViViViViViViViViViViViViViViViViViViViViViViViViViViViViViViViVi
"}
