"zx" = (/turf/simulated/floor/plating,/area/space)
"Ov" = (/turf/simulated/wall/r_wall/prepainted,/area/space)
"Vi" = (/turf/space/sky,/area/space)

(1,1,1) = {"
ViViViViViViViViViViViViViViViViViViViViViViViViViViViViViViViViViViViViViViViViViViViViViViViViViViViViViViViViViViViViViViViViViViViViViViViViViViViViViViViVi
ViViViViViViViViViViViViViViViViViViViViViViViViViViViViViViViViViViViViViViViViViViViViViViViViViViViViViViViViViViViViViViViViViViViViViViViViViViViViViViViVi
ViViViViViViViViViViViViViViViViViViViViViViViViViViViViViViViViViViViViViViViViViViViViViViViViViViViViViViViViViViViViViViViViViViViViViViViViViViViViViViViVi
ViViViOvOvOvOvOvOvOvOvOvOvOvOvOvOvOvOvOvOvOvOvOvOvOvOvOvOvOvOvOvOvOvOvOvOvOvOvOvOvOvOvOvOvOvOvOvOvOvOvOvOvOvOvOvOvOvOvOvOvOvOvOvOvOvOvOvOvOvOvOvOvOvOvOvOvViViVi
ViViViOvOvOvOvOvOvOvOvOvOvOvOvOvOvOvOvOvOvOvOvOvOvOvOvOvOvOvOvOvOvOvOvOvOvOvOvOvOvOvOvOvOvOvOvOvOvOvOvOvOvOvOvOvOvOvOvOvOvOvOvOvOvOvOvOvOvOvOvOvOvOvOvOvOvViViVi
ViViViOvOvOvOvOvOvOvOvOvOvOvOvOvOvOvOvOvOvOvOvOvOvOvOvOvOvOvOvOvOvOvOvOvOvOvOvOvOvOvOvOvOvOvOvOvOvOvOvOvOvOvOvOvOvOvOvOvOvOvOvOvOvOvOvOvOvOvOvOvOvOvOvOvOvViViVi
ViViViOvOvOvzxzxzxzxzxzxzxzxzxzxzxzxzxzxzxzxzxzxzxzxzxzxzxzxzxzxzxzxzxzxzxzxzxzxzxzxzxzxzxzxzxzxzxzxzxzxzxzxzxzxzxzxzxzxzxzxzxzxzxzxzxzxzxzxzxzxzxzxOvOvOvViViVi
ViViViOvOvOvzxzxzxzxzxzxzxzxzxzxzxzxzxzxzxzxzxzxzxzxzxzxzxzxzxzxzxzxzxzxzxzxzxzxzxzxzxzxzxzxzxzxzxzxzxzxzxzxzxzxzxzxzxzxzxzxzxzxzxzxzxzxzxzxzxzxzxzxOvOvOvViViVi
ViViViOvOvOvzxzxzxzxzxzxzxzxzxzxzxzxzxzxzxzxzxzxzxzxzxzxzxzxzxzxzxzxzxzxzxzxzxzxzxzxzxzxzxzxzxzxzxzxzxzxzxzxzxzxzxzxzxzxzxzxzxzxzxzxzxzxzxzxzxzxzxzxOvOvOvViViVi
ViViViOvOvOvzxzxzxzxzxzxzxzxzxzxzxzxzxzxzxzxzxzxzxzxzxzxzxzxzxzxzxzxzxzxzxzxzxzxzxzxzxzxzxzxzxzxzxzxzxzxzxzxzxzxzxzxzxzxzxzxzxzxzxzxzxzxzxzxzxzxzxzxOvOvOvViViVi
ViViViOvOvOvzxzxzxzxzxzxzxzxzxzxzxzxzxzxzxzxzxzxzxzxzxzxzxzxzxzxzxzxzxzxzxzxzxzxzxzxzxzxzxzxzxzxzxzxzxzxzxzxzxzxzxzxzxzxzxzxzxzxzxzxzxzxzxzxzxzxzxzxOvOvOvViViVi
ViViViOvOvOvzxzxzxzxzxzxzxzxzxzxzxzxzxzxzxzxzxzxzxzxzxzxzxzxzxzxzxzxzxzxzxzxzxzxzxzxzxzxzxzxzxzxzxzxzxzxzxzxzxzxzxzxzxzxzxzxzxzxzxzxzxzxzxzxzxzxzxzxOvOvOvViViVi
ViViViOvOvOvzxzxzxzxzxzxzxzxzxzxzxzxzxzxzxzxzxzxzxzxzxzxzxzxzxzxzxzxzxzxzxzxzxzxzxzxzxzxzxzxzxzxzxzxzxzxzxzxzxzxzxzxzxzxzxzxzxzxzxzxzxzxzxzxzxzxzxzxOvOvOvViViVi
ViViViOvOvOvzxzxzxzxzxzxzxzxzxzxzxzxzxzxzxzxzxzxzxzxzxzxzxzxzxzxzxzxzxzxzxzxzxzxzxzxzxzxzxzxzxzxzxzxzxzxzxzxzxzxzxzxzxzxzxzxzxzxzxzxzxzxzxzxzxzxzxzxOvOvOvViViVi
ViViViOvOvOvzxzxzxzxzxzxzxzxzxzxzxzxzxzxzxzxzxzxzxzxzxzxzxzxzxzxzxzxzxzxzxzxzxzxzxzxzxzxzxzxzxzxzxzxzxzxzxzxzxzxzxzxzxzxzxzxzxzxzxzxzxzxzxzxzxzxzxzxOvOvOvViViVi
ViViViOvOvOvzxzxzxzxzxzxzxzxzxzxzxzxzxzxzxzxzxzxzxzxzxzxzxzxzxzxzxzxzxzxzxzxzxzxzxzxzxzxzxzxzxzxzxzxzxzxzxzxzxzxzxzxzxzxzxzxzxzxzxzxzxzxzxzxzxzxzxzxOvOvOvViViVi
ViViViOvOvOvzxzxzxzxzxzxzxzxzxzxzxzxzxzxzxzxzxzxzxzxzxzxzxzxzxzxzxzxzxzxzxzxzxzxzxzxzxzxzxzxzxzxzxzxzxzxzxzxzxzxzxzxzxzxzxzxzxzxzxzxzxzxzxzxzxzxzxzxOvOvOvViViVi
ViViViOvOvOvzxzxzxzxzxzxzxzxzxzxzxzxzxzxzxzxzxzxzxzxzxzxzxzxzxzxzxzxzxzxzxzxzxzxzxzxzxzxzxzxzxzxzxzxzxzxzxzxzxzxzxzxzxzxzxzxzxzxzxzxzxzxzxzxzxzxzxzxOvOvOvViViVi
ViViViOvOvOvzxzxzxzxzxzxzxzxzxzxzxzxzxzxzxzxzxzxzxzxzxzxzxzxzxzxzxzxzxzxzxzxzxzxzxzxzxzxzxzxzxzxzxzxzxzxzxzxzxzxzxzxzxzxzxzxzxzxzxzxzxzxzxzxzxzxzxzxOvOvOvViViVi
ViViViOvOvOvzxzxzxzxzxzxzxzxzxzxzxzxzxzxzxzxzxzxzxzxzxzxzxzxzxzxzxzxzxzxzxzxzxzxzxzxzxzxzxzxzxzxzxzxzxzxzxzxzxzxzxzxzxzxzxzxzxzxzxzxzxzxzxzxzxzxzxzxOvOvOvViViVi
ViViViOvOvOvzxzxzxzxzxzxzxzxzxzxzxzxzxzxzxzxzxzxzxzxzxzxzxzxzxzxzxzxzxzxzxzxzxzxzxzxzxzxzxzxzxzxzxzxzxzxzxzxzxzxzxzxzxzxzxzxzxzxzxzxzxzxzxzxzxzxzxzxOvOvOvViViVi
ViViViOvOvOvzxzxzxzxzxzxzxzxzxzxzxzxzxzxzxzxzxzxzxzxzxzxzxzxzxzxzxzxzxzxzxzxzxzxzxzxzxzxzxzxzxzxzxzxzxzxzxzxzxzxzxzxzxzxzxzxzxzxzxzxzxzxzxzxzxzxzxzxOvOvOvViViVi
ViViViOvOvOvzxzxzxzxzxzxzxzxzxzxzxzxzxzxzxzxzxzxzxzxzxzxzxzxzxzxzxzxzxzxzxzxzxzxzxzxzxzxzxzxzxzxzxzxzxzxzxzxzxzxzxzxzxzxzxzxzxzxzxzxzxzxzxzxzxzxzxzxOvOvOvViViVi
ViViViOvOvOvzxzxzxzxzxzxzxzxzxzxzxzxzxzxzxzxzxzxzxzxzxzxzxzxzxzxzxzxzxzxzxzxzxzxzxzxzxzxzxzxzxzxzxzxzxzxzxzxzxzxzxzxzxzxzxzxzxzxzxzxzxzxzxzxzxzxzxzxOvOvOvViViVi
ViViViOvOvOvzxzxzxzxzxzxzxzxzxzxzxzxzxzxzxzxzxzxzxzxzxzxzxzxzxzxzxzxzxzxzxzxzxzxzxzxzxzxzxzxzxzxzxzxzxzxzxzxzxzxzxzxzxzxzxzxzxzxzxzxzxzxzxzxzxzxzxzxOvOvOvViViVi
ViViViOvOvOvzxzxzxzxzxzxzxzxzxzxzxzxzxzxzxzxzxzxzxzxzxzxzxzxzxzxzxzxzxzxzxzxzxzxzxzxzxzxzxzxzxzxzxzxzxzxzxzxzxzxzxzxzxzxzxzxzxzxzxzxzxzxzxzxzxzxzxzxOvOvOvViViVi
ViViViOvOvOvzxzxzxzxzxzxzxzxzxzxzxzxzxzxzxzxzxzxzxzxzxzxzxzxzxzxzxzxzxzxzxzxzxzxzxzxzxzxzxzxzxzxzxzxzxzxzxzxzxzxzxzxzxzxzxzxzxzxzxzxzxzxzxzxzxzxzxzxOvOvOvViViVi
ViViViOvOvOvzxzxzxzxzxzxzxzxzxzxzxzxzxzxzxzxzxzxzxzxzxzxzxzxzxzxzxzxzxzxzxzxzxzxzxzxzxzxzxzxzxzxzxzxzxzxzxzxzxzxzxzxzxzxzxzxzxzxzxzxzxzxzxzxzxzxzxzxOvOvOvViViVi
ViViViOvOvOvzxzxzxzxzxzxzxzxzxzxzxzxzxzxzxzxzxzxzxzxzxzxzxzxzxzxzxzxzxzxzxzxzxzxzxzxzxzxzxzxzxzxzxzxzxzxzxzxzxzxzxzxzxzxzxzxzxzxzxzxzxzxzxzxzxzxzxzxOvOvOvViViVi
ViViViOvOvOvzxzxzxzxzxzxzxzxzxzxzxzxzxzxzxzxzxzxzxzxzxzxzxzxzxzxzxzxzxzxzxzxzxzxzxzxzxzxzxzxzxzxzxzxzxzxzxzxzxzxzxzxzxzxzxzxzxzxzxzxzxzxzxzxzxzxzxzxOvOvOvViViVi
ViViViOvOvOvzxzxzxzxzxzxzxzxzxzxzxzxzxzxzxzxzxzxzxzxzxzxzxzxzxzxzxzxzxzxzxzxzxzxzxzxzxzxzxzxzxzxzxzxzxzxzxzxzxzxzxzxzxzxzxzxzxzxzxzxzxzxzxzxzxzxzxzxOvOvOvViViVi
ViViViOvOvOvzxzxzxzxzxzxzxzxzxzxzxzxzxzxzxzxzxzxzxzxzxzxzxzxzxzxzxzxzxzxzxzxzxzxzxzxzxzxzxzxzxzxzxzxzxzxzxzxzxzxzxzxzxzxzxzxzxzxzxzxzxzxzxzxzxzxzxzxOvOvOvViViVi
ViViViOvOvOvzxzxzxzxzxzxzxzxzxzxzxzxzxzxzxzxzxzxzxzxzxzxzxzxzxzxzxzxzxzxzxzxzxzxzxzxzxzxzxzxzxzxzxzxzxzxzxzxzxzxzxzxzxzxzxzxzxzxzxzxzxzxzxzxzxzxzxzxOvOvOvViViVi
ViViViOvOvOvzxzxzxzxzxzxzxzxzxzxzxzxzxzxzxzxzxzxzxzxzxzxzxzxzxzxzxzxzxzxzxzxzxzxzxzxzxzxzxzxzxzxzxzxzxzxzxzxzxzxzxzxzxzxzxzxzxzxzxzxzxzxzxzxzxzxzxzxOvOvOvViViVi
ViViViOvOvOvzxzxzxzxzxzxzxzxzxzxzxzxzxzxzxzxzxzxzxzxzxzxzxzxzxzxzxzxzxzxzxzxzxzxzxzxzxzxzxzxzxzxzxzxzxzxzxzxzxzxzxzxzxzxzxzxzxzxzxzxzxzxzxzxzxzxzxzxOvOvOvViViVi
ViViViOvOvOvzxzxzxzxzxzxzxzxzxzxzxzxzxzxzxzxzxzxzxzxzxzxzxzxzxzxzxzxzxzxzxzxzxzxzxzxzxzxzxzxzxzxzxzxzxzxzxzxzxzxzxzxzxzxzxzxzxzxzxzxzxzxzxzxzxzxzxzxOvOvOvViViVi
ViViViOvOvOvzxzxzxzxzxzxzxzxzxzxzxzxzxzxzxzxzxzxzxzxzxzxzxzxzxzxzxzxzxzxzxzxzxzxzxzxzxzxzxzxzxzxzxzxzxzxzxzxzxzxzxzxzxzxzxzxzxzxzxzxzxzxzxzxzxzxzxzxOvOvOvViViVi
ViViViOvOvOvzxzxzxzxzxzxzxzxzxzxzxzxzxzxzxzxzxzxzxzxzxzxzxzxzxzxzxzxzxzxzxzxzxzxzxzxzxzxzxzxzxzxzxzxzxzxzxzxzxzxzxzxzxzxzxzxzxzxzxzxzxzxzxzxzxzxzxzxOvOvOvViViVi
ViViViOvOvOvzxzxzxzxzxzxzxzxzxzxzxzxzxzxzxzxzxzxzxzxzxzxzxzxzxzxzxzxzxzxzxzxzxzxzxzxzxzxzxzxzxzxzxzxzxzxzxzxzxzxzxzxzxzxzxzxzxzxzxzxzxzxzxzxzxzxzxzxOvOvOvViViVi
ViViViOvOvOvzxzxzxzxzxzxzxzxzxzxzxzxzxzxzxzxzxzxzxzxzxzxzxzxzxzxzxzxzxzxzxzxzxzxzxzxzxzxzxzxzxzxzxzxzxzxzxzxzxzxzxzxzxzxzxzxzxzxzxzxzxzxzxzxzxzxzxzxOvOvOvViViVi
ViViViOvOvOvzxzxzxzxzxzxzxzxzxzxzxzxzxzxzxzxzxzxzxzxzxzxzxzxzxzxzxzxzxzxzxzxzxzxzxzxzxzxzxzxzxzxzxzxzxzxzxzxzxzxzxzxzxzxzxzxzxzxzxzxzxzxzxzxzxzxzxzxOvOvOvViViVi
ViViViOvOvOvzxzxzxzxzxzxzxzxzxzxzxzxzxzxzxzxzxzxzxzxzxzxzxzxzxzxzxzxzxzxzxzxzxzxzxzxzxzxzxzxzxzxzxzxzxzxzxzxzxzxzxzxzxzxzxzxzxzxzxzxzxzxzxzxzxzxzxzxOvOvOvViViVi
ViViViOvOvOvzxzxzxzxzxzxzxzxzxzxzxzxzxzxzxzxzxzxzxzxzxzxzxzxzxzxzxzxzxzxzxzxzxzxzxzxzxzxzxzxzxzxzxzxzxzxzxzxzxzxzxzxzxzxzxzxzxzxzxzxzxzxzxzxzxzxzxzxOvOvOvViViVi
ViViViOvOvOvzxzxzxzxzxzxzxzxzxzxzxzxzxzxzxzxzxzxzxzxzxzxzxzxzxzxzxzxzxzxzxzxzxzxzxzxzxzxzxzxzxzxzxzxzxzxzxzxzxzxzxzxzxzxzxzxzxzxzxzxzxzxzxzxzxzxzxzxOvOvOvViViVi
ViViViOvOvOvzxzxzxzxzxzxzxzxzxzxzxzxzxzxzxzxzxzxzxzxzxzxzxzxzxzxzxzxzxzxzxzxzxzxzxzxzxzxzxzxzxzxzxzxzxzxzxzxzxzxzxzxzxzxzxzxzxzxzxzxzxzxzxzxzxzxzxzxOvOvOvViViVi
ViViViOvOvOvzxzxzxzxzxzxzxzxzxzxzxzxzxzxzxzxzxzxzxzxzxzxzxzxzxzxzxzxzxzxzxzxzxzxzxzxzxzxzxzxzxzxzxzxzxzxzxzxzxzxzxzxzxzxzxzxzxzxzxzxzxzxzxzxzxzxzxzxOvOvOvViViVi
ViViViOvOvOvzxzxzxzxzxzxzxzxzxzxzxzxzxzxzxzxzxzxzxzxzxzxzxzxzxzxzxzxzxzxzxzxzxzxzxzxzxzxzxzxzxzxzxzxzxzxzxzxzxzxzxzxzxzxzxzxzxzxzxzxzxzxzxzxzxzxzxzxOvOvOvViViVi
ViViViOvOvOvzxzxzxzxzxzxzxzxzxzxzxzxzxzxzxzxzxzxzxzxzxzxzxzxzxzxzxzxzxzxzxzxzxzxzxzxzxzxzxzxzxzxzxzxzxzxzxzxzxzxzxzxzxzxzxzxzxzxzxzxzxzxzxzxzxzxzxzxOvOvOvViViVi
ViViViOvOvOvzxzxzxzxzxzxzxzxzxzxzxzxzxzxzxzxzxzxzxzxzxzxzxzxzxzxzxzxzxzxzxzxzxzxzxzxzxzxzxzxzxzxzxzxzxzxzxzxzxzxzxzxzxzxzxzxzxzxzxzxzxzxzxzxzxzxzxzxOvOvOvViViVi
ViViViOvOvOvzxzxzxzxzxzxzxzxzxzxzxzxzxzxzxzxzxzxzxzxzxzxzxzxzxzxzxzxzxzxzxzxzxzxzxzxzxzxzxzxzxzxzxzxzxzxzxzxzxzxzxzxzxzxzxzxzxzxzxzxzxzxzxzxzxzxzxzxOvOvOvViViVi
ViViViOvOvOvzxzxzxzxzxzxzxzxzxzxzxzxzxzxzxzxzxzxzxzxzxzxzxzxzxzxzxzxzxzxzxzxzxzxzxzxzxzxzxzxzxzxzxzxzxzxzxzxzxzxzxzxzxzxzxzxzxzxzxzxzxzxzxzxzxzxzxzxOvOvOvViViVi
ViViViOvOvOvzxzxzxzxzxzxzxzxzxzxzxzxzxzxzxzxzxzxzxzxzxzxzxzxzxzxzxzxzxzxzxzxzxzxzxzxzxzxzxzxzxzxzxzxzxzxzxzxzxzxzxzxzxzxzxzxzxzxzxzxzxzxzxzxzxzxzxzxOvOvOvViViVi
ViViViOvOvOvzxzxzxzxzxzxzxzxzxzxzxzxzxzxzxzxzxzxzxzxzxzxzxzxzxzxzxzxzxzxzxzxzxzxzxzxzxzxzxzxzxzxzxzxzxzxzxzxzxzxzxzxzxzxzxzxzxzxzxzxzxzxzxzxzxzxzxzxOvOvOvViViVi
ViViViOvOvOvzxzxzxzxzxzxzxzxzxzxzxzxzxzxzxzxzxzxzxzxzxzxzxzxzxzxzxzxzxzxzxzxzxzxzxzxzxzxzxzxzxzxzxzxzxzxzxzxzxzxzxzxzxzxzxzxzxzxzxzxzxzxzxzxzxzxzxzxOvOvOvViViVi
ViViViOvOvOvzxzxzxzxzxzxzxzxzxzxzxzxzxzxzxzxzxzxzxzxzxzxzxzxzxzxzxzxzxzxzxzxzxzxzxzxzxzxzxzxzxzxzxzxzxzxzxzxzxzxzxzxzxzxzxzxzxzxzxzxzxzxzxzxzxzxzxzxOvOvOvViViVi
ViViViOvOvOvzxzxzxzxzxzxzxzxzxzxzxzxzxzxzxzxzxzxzxzxzxzxzxzxzxzxzxzxzxzxzxzxzxzxzxzxzxzxzxzxzxzxzxzxzxzxzxzxzxzxzxzxzxzxzxzxzxzxzxzxzxzxzxzxzxzxzxzxOvOvOvViViVi
ViViViOvOvOvzxzxzxzxzxzxzxzxzxzxzxzxzxzxzxzxzxzxzxzxzxzxzxzxzxzxzxzxzxzxzxzxzxzxzxzxzxzxzxzxzxzxzxzxzxzxzxzxzxzxzxzxzxzxzxzxzxzxzxzxzxzxzxzxzxzxzxzxOvOvOvViViVi
ViViViOvOvOvzxzxzxzxzxzxzxzxzxzxzxzxzxzxzxzxzxzxzxzxzxzxzxzxzxzxzxzxzxzxzxzxzxzxzxzxzxzxzxzxzxzxzxzxzxzxzxzxzxzxzxzxzxzxzxzxzxzxzxzxzxzxzxzxzxzxzxzxOvOvOvViViVi
ViViViOvOvOvzxzxzxzxzxzxzxzxzxzxzxzxzxzxzxzxzxzxzxzxzxzxzxzxzxzxzxzxzxzxzxzxzxzxzxzxzxzxzxzxzxzxzxzxzxzxzxzxzxzxzxzxzxzxzxzxzxzxzxzxzxzxzxzxzxzxzxzxOvOvOvViViVi
ViViViOvOvOvzxzxzxzxzxzxzxzxzxzxzxzxzxzxzxzxzxzxzxzxzxzxzxzxzxzxzxzxzxzxzxzxzxzxzxzxzxzxzxzxzxzxzxzxzxzxzxzxzxzxzxzxzxzxzxzxzxzxzxzxzxzxzxzxzxzxzxzxOvOvOvViViVi
ViViViOvOvOvzxzxzxzxzxzxzxzxzxzxzxzxzxzxzxzxzxzxzxzxzxzxzxzxzxzxzxzxzxzxzxzxzxzxzxzxzxzxzxzxzxzxzxzxzxzxzxzxzxzxzxzxzxzxzxzxzxzxzxzxzxzxzxzxzxzxzxzxOvOvOvViViVi
ViViViOvOvOvzxzxzxzxzxzxzxzxzxzxzxzxzxzxzxzxzxzxzxzxzxzxzxzxzxzxzxzxzxzxzxzxzxzxzxzxzxzxzxzxzxzxzxzxzxzxzxzxzxzxzxzxzxzxzxzxzxzxzxzxzxzxzxzxzxzxzxzxOvOvOvViViVi
ViViViOvOvOvzxzxzxzxzxzxzxzxzxzxzxzxzxzxzxzxzxzxzxzxzxzxzxzxzxzxzxzxzxzxzxzxzxzxzxzxzxzxzxzxzxzxzxzxzxzxzxzxzxzxzxzxzxzxzxzxzxzxzxzxzxzxzxzxzxzxzxzxOvOvOvViViVi
ViViViOvOvOvzxzxzxzxzxzxzxzxzxzxzxzxzxzxzxzxzxzxzxzxzxzxzxzxzxzxzxzxzxzxzxzxzxzxzxzxzxzxzxzxzxzxzxzxzxzxzxzxzxzxzxzxzxzxzxzxzxzxzxzxzxzxzxzxzxzxzxzxOvOvOvViViVi
ViViViOvOvOvOvOvOvOvOvOvOvOvOvzxzxzxzxzxzxzxzxzxzxzxzxzxzxzxzxzxzxzxzxzxzxzxzxzxzxzxzxzxzxzxzxzxzxzxzxzxzxzxzxzxzxzxzxzxzxzxzxzxzxzxzxzxzxzxzxzxzxzxOvOvOvViViVi
ViViViOvOvOvOvOvOvOvOvOvOvOvOvzxzxzxzxzxzxzxzxzxzxzxzxzxzxzxzxzxzxzxzxzxzxzxzxzxzxzxzxzxzxzxzxzxzxzxzxzxzxzxzxzxzxzxzxzxzxzxzxzxzxzxzxzxzxzxzxzxzxzxOvOvOvViViVi
ViViViOvOvOvOvOvOvOvOvOvOvOvOvzxzxzxzxzxzxzxzxzxzxzxzxzxzxzxzxzxzxzxzxzxzxzxzxzxzxzxzxzxzxzxzxzxzxzxzxzxzxzxzxzxzxzxzxzxzxzxzxzxzxzxzxzxzxzxzxzxzxzxOvOvOvViViVi
ViViViOvOvOvOvOvOvOvOvOvOvOvOvzxzxzxzxzxzxzxzxzxzxzxzxzxzxzxzxzxzxzxzxzxzxzxzxzxzxzxzxzxzxzxzxzxzxzxzxzxzxzxzxzxzxzxzxzxzxzxzxzxzxzxzxzxzxzxzxzxzxzxOvOvOvViViVi
ViViViOvOvOvOvzxzxzxzxOvOvOvOvzxzxzxzxzxzxzxzxzxzxzxzxzxzxzxzxzxzxzxzxzxzxzxzxzxzxzxzxzxzxzxzxzxzxzxzxzxzxzxzxzxzxzxzxzxzxzxzxzxzxzxzxzxzxzxzxzxzxzxOvOvOvViViVi
ViViViOvOvOvOvzxzxzxzxOvOvOvOvzxzxzxzxzxzxzxzxzxzxzxzxzxzxzxzxzxzxzxzxzxzxzxzxzxzxzxzxzxzxzxzxzxzxzxzxzxzxzxzxzxzxzxzxzxzxzxzxzxzxzxzxzxzxzxzxzxzxzxOvOvOvViViVi
ViViViOvOvOvOvzxzxzxzxOvOvOvOvzxzxzxzxzxzxzxzxzxzxzxzxzxzxzxzxzxzxzxzxzxzxzxzxzxzxzxzxzxzxzxzxzxzxzxzxzxzxzxzxzxzxzxzxzxzxzxzxzxzxzxzxzxzxzxzxzxzxzxOvOvOvViViVi
ViViViOvOvOvOvzxzxzxzxOvOvOvOvzxzxzxzxzxzxzxzxzxzxzxzxzxzxzxzxzxzxzxzxzxzxzxzxzxzxzxzxzxzxzxzxzxzxzxzxzxzxzxzxzxzxzxzxzxzxzxzxzxzxzxzxzxzxzxzxzxzxzxOvOvOvViViVi
ViViViOvOvOvOvOvOvOvOvOvOvOvOvzxzxzxzxzxzxzxzxzxzxzxzxzxzxzxzxzxzxzxzxzxzxzxzxzxzxzxzxzxzxzxzxzxzxzxzxzxzxzxzxzxzxzxzxzxzxzxzxzxzxzxzxzxzxzxzxzxzxzxOvOvOvViViVi
ViViViOvOvOvOvOvOvOvOvOvOvOvOvOvOvOvOvOvOvOvOvOvOvOvOvOvOvOvOvOvOvOvOvOvOvOvOvOvOvOvOvOvOvOvOvOvOvOvOvOvOvOvOvOvOvOvOvOvOvOvOvOvOvOvOvOvOvOvOvOvOvOvOvOvOvViViVi
ViViViOvOvOvOvOvOvOvOvOvOvOvOvOvOvOvOvOvOvOvOvOvOvOvOvOvOvOvOvOvOvOvOvOvOvOvOvOvOvOvOvOvOvOvOvOvOvOvOvOvOvOvOvOvOvOvOvOvOvOvOvOvOvOvOvOvOvOvOvOvOvOvOvOvOvViViVi
ViViViOvOvOvOvOvOvOvOvOvOvOvOvOvOvOvOvOvOvOvOvOvOvOvOvOvOvOvOvOvOvOvOvOvOvOvOvOvOvOvOvOvOvOvOvOvOvOvOvOvOvOvOvOvOvOvOvOvOvOvOvOvOvOvOvOvOvOvOvOvOvOvOvOvOvViViVi
ViViViViViViViViViViViViViViViViViViViViViViViViViViViViViViViViViViViViViViViViViViViViViViViViViViViViViViViViViViViViViViViViViViViViViViViViViViViViViViViVi
ViViViViViViViViViViViViViViViViViViViViViViViViViViViViViViViViViViViViViViViViViViViViViViViViViViViViViViViViViViViViViViViViViViViViViViViViViViViViViViViVi
ViViViViViViViViViViViViViViViViViViViViViViViViViViViViViViViViViViViViViViViViViViViViViViViViViViViViViViViViViViViViViViViViViViViViViViViViViViViViViViViVi
ViViViViViViViViViViViViViViViViViViViViViViViViViViViViViViViViViViViViViViViViViViViViViViViViViViViViViViViViViViViViViViViViViViViViViViViViViViViViViViViVi
"}
