"a" = (/turf/space/sky,/area/space)
"r" = (/turf/simulated/floor/plating,/area/space)
"M" = (/turf/simulated/wall/r_wall/prepainted,/area/space)
"Z" = (/mob/living/simple_animal/hostile/creature,/turf/simulated/floor/plating,/area/space)

(1,1,1) = {"
aaaaaaaaaaaaaaaaaaaaaaaaaaaaaaaaaaaaaaaaaaaaaaaaaaaaaaaaaaaaaaaaaaaaaaaaaaaaaaaa
aaaaaaaaaaaaaaaaaaaaaaaaaaaaaaaaaaaaaaaaaaaaaaaaaaaaaaaaaaaaaaaaaaaaaaaaaaaaaaaa
aaaaaaaaaaaaaaaaaaaaaaaaaaaaaaaaaaaaaaaaaaaaaaaaaaaaaaaaaaaaaaaaaaaaaaaaaaaaaaaa
aaaMMMMMMMMMMMMMMMMMMMMMMMMMMMMMMMMMMMMMMMMMMMMMMMMMMMMMMMMMMMMMMMMMMMMMMMMMMaaa
aaaMMMMMMMMMMMMMMMMMMMMMMMMMMMMMMMMMMMMMMMMMMMMMMMMMMMMMMMMMMMMMMMMMMMMMMMMMMaaa
aaaMMMMMMMMMMMMMMMMMMMMMMMMMMMMMMMMMMMMMMMMMMMMMMMMMMMMMMMMMMMMMMMMMMMMMMMMMMaaa
aaaMMMrrrrrrrrrrrrrrrrrrrrrrrrrrrrrrrrrrrrrrrrrrrrrrrrrrrrrrrrrrrrrrrrrrrrMMMaaa
aaaMMMrrrrrrrrrrrrrrrrrrrrrrrrrrrrrrrrrrrrrrrrrrrrrrrrrrrrrrrrrrrrrrrrrrrrMMMaaa
aaaMMMrrrrrrrrrrrrrrrrrrZrrrrrrrrrrrrrrrrrrrrrrrrrrrrrrrrrrrrrrrrrrrrrrrrrMMMaaa
aaaMMMrrrrrrrrrrrrrrrrrrrrrrrrrrrrrrrrrrrrrrrrrrrrrrrrrrrrrrrrrrrrrrrrrrrrMMMaaa
aaaMMMrrrrrrrrrrrrrrrrrrrrrrrrrrrrrrrrrrrrrrrrrrrrrrrrrrrrrrrrrrrrrrrrrrrrMMMaaa
aaaMMMrrrrrrrrrrrrrrrrrrrrrrrrrrrrrrrrrrrrrrrrrrrrrrrrrrrrrrrrrrrrrrrrrrrrMMMaaa
aaaMMMrrrrrrrrZrrrrrrrrrrrrrrrrrrrrrrZrrrrrrrrrrrrrrrrrrrrrrrrrrrrrrrrrrrrMMMaaa
aaaMMMrrrrrrrrrrrrrrrrrrrrrrrrrrrrrrrrrrrrrrrrrrrrrrrrrrrrrrrZrrrrrrrrrrrrMMMaaa
aaaMMMrZrrrrrrrrrrrrrrrrrrrrrrrrrrrrrrrrrrrrrrrZrrrrrrrrrrrrrrrrrrrrrrrrrrMMMaaa
aaaMMMrrrrrrrrrrrrrrrrrrrrrrrZrrrrrrrrrrrrrrrrrrrrrrrrrrrrrrrrrrrrrrrrrrrrMMMaaa
aaaMMMrrrrrrrrrrrrrrrrrrrrrrrrrrrrrrrrrrrrrrrrrrrrrrrrrrrrrrrrrrrrrrrrrrrrMMMaaa
aaaMMMrrrrrrrrrrrrrrrrrrrrrrrrrZrrrrrrrrrrrrrrrrrrrrrrrrrrrrrrrrrrrrrrrrrrMMMaaa
aaaMMMrrrrrrrrrrrrrrrrrrrrrrrrrrrrrrrrrrrrrrrrrrrrrrrrrrrrrrrrrrrrrrrrrrrrMMMaaa
aaaMMMrrrrrrrrrrrrrZrrrrrrrrrrrrrrrrrrrZrrrrrrrrrrrrrrrrrrrrrrrrrrrrrrrrrrMMMaaa
aaaMMMrrrrrrrrrrrrrrrrrrrrrrrrrrrrrrrrrrrrrrrrrrrrrrrrrrrrrrrrrrrrrrrrrrrrMMMaaa
aaaMMMrrrrrrrrrrrrrrrrrrrrrrrrrrrrrrrrrrrrrrrrrrrrrrrrrrrrrrrrrrrrrrrrrrrrMMMaaa
aaaMMMrrrrrrrrrrrrrrrrrrrrrrrrrrrrrrrrrrrrrrrrrrrrrrrrrrrrrrrrrrrrrrrrrrrrMMMaaa
aaaMMMrrrrrrrrrrrrrrrrrrrrrrrrrrrrrrrrrrrrrrrrrrrrrrrrrrrrrrrrrrrrrrrrrrrrMMMaaa
aaaMMMrrrrrrrrrrrrrrrrrrrrrrZrrrrrrZrrrrrrrrrrrrrrrrrrrrrrrrrrrrrrrrrrrrrrMMMaaa
aaaMMMrrrrrrrrrrrrrrrrrrrrrrrrrrrrrrrrrrrrrrrrrrrrrrrrrrrrrrrrrrrrrrrrrrrrMMMaaa
aaaMMMrrrrrrrZrrrrrrrrrrrrrrrrrrrrrrrrrrrrrrrrrrrrrrrrrrrrrrrrrrrrrrrrrrrrMMMaaa
aaaMMMrrrrrrrrrrrrrrrrrrrrrrrrrrrrrrrrrrrrrrrrrrrrrZrrrrrrrrrrrrrrrrrrrrrrMMMaaa
aaaMMMrrrrrrrrrrrrrrrrrrrrrrrrrrrrrrrrrrrrrrrrrZrrrrrrrrrrrrrrrrrrrrrrrrrrMMMaaa
aaaMMMrrrrrrrrrrrrrrrrrrrrrrrrrrrrrrrrrrrrrrrrrrrrrrrrrrrrrrrrrrrrrrrrrrrrMMMaaa
aaaMMMrrrrrrrrrrrrrrrrrrrZrrrrrrrrrrZrrrrrrrrrrrrrrrrrrrrrrrrrrrrrrrrrrrrrMMMaaa
aaaMMMrrrrrrrrrrrrrrrrrrrrrrrrrrrrrrZrrrrrrrrrrrrrrrrrrrrrrrrrrrrrrrrrrrrrMMMaaa
aaaMMMrrrrrrrrrrrrrrrrrrrrrrrrrrrrrrrrrrrrrrrZrrrrrrrrrrrrrrrrrrrrrrrrrrrrMMMaaa
aaaMMMrrrrrrrrrrrrrrrrrrrrrrrrrrrrrrrrrrrrrrrrrrrrrrrrrrrrrrrrrrrrrrrrrrrrMMMaaa
aaaMMMMMMMMMMMMMMMMrrrrrrrrrrrrrrrrrrrrrrrrrrrrrrrrrrrrrrrrrrrrrrrrrrrrrrrMMMaaa
aaaMMMMMMMMMMMMMMMMrrrrrrrrrrrrrrrrrrrrrrrrrrrrrrrrrrrrrrrrrrrrrrrrrrrrrrrMMMaaa
aaaMMMrrrrrMMrrrrMMMMMMMMMMMrMMMMMMMMMMMMMMMMMMMMMMrrrrrrrrrrrrrrrrrrrrrrrMMMaaa
aaaMMMrrrrrMMrrrrMMMMMMMMMMMrMMMMMMMMMMMMMMMMMMMMMMrrrrrrrrrrrrrrrrrrrrrrrMMMaaa
aaaMMMrrrrrMMrrrrMMrrrrrrrrrrrrrrrrrrrrrrrrrrrrrMMrrrrrrrrrrrrrrrrrrrrrrrrMMMaaa
aaaMMMrrrrrMMrrrrMMrrrrrrrrrrrrrrrrrrrrrrrrrrrrrMMrrrrrrrrrrrrrrrrrrrrrrrrMMMaaa
aaaMMMMMrMMMMrrrrMMrrrrrrrrrrrrrrrrrrrrrrrrrrrrrMMrrrrrrrrrrrrrrrrrrrrrrrrMMMaaa
aaaMMMMMrMMMMrrrrMMrrrrrrrrrrrrrrrrrrrrrrrrrrrrrMMrrrrrrrrrrrrrrrrrrrrrrrrMMMaaa
aaaMMMrrrrrrrrrrrMMrrrrrrrrrrrrrrrrrrrrrrrrrrrrrMMrrrrrrrrrrrrrrrrrrrrrrrrMMMaaa
aaaMMMrrrrrMMrrrrMMrrrrrrrrrrrrrrrrrrrrrrrrrrrrrMMrrrrrrrrrrrrrrrrrrrrrrrrMMMaaa
aaaMMMrrrrrMMrrrrMMrrrrrrrrrrrrrrrrrrrrrrrrrrrrrMMrrrrrrrrrrrrrrrrrrrrrrrrMMMaaa
aaaMMMrrrrrMMrrrrMMrrrrrrrrrrrrrrrrrrrrrrrrrrrrrMMrrrrrrrrrrrrrrrrrrrrrrrrMMMaaa
aaaMMMMMMMMMMrrrrMMrrrrrrrrrrrrrrrrrrrrrrrrrrrrrrrrrrrrrrrrrrrrrrrrrrrrrrrMMMaaa
aaaMMMMMMMMMMrrrrMMrrrrrrrrrrrrrrrrrrrrrrrrrrrrrMMrrrrrrrrrrrrrrrrrrrrrrrrMMMaaa
aaaMMMrrrrrMMrrrrMMrrrrrrrrrrrrrrrrrrrrrrrrrrrrrMMrrrrrrrrrrrrrrrrrrrrrrrrMMMaaa
aaaMMMrrrrrrrrrrrMMrrrrrrrrrrrrrrrrrrrrrrrrrrrrrMMrrrrrrrrrrrrrrrrrrrrrrrrMMMaaa
aaaMMMMMMMMMMrrrrMMrrrrrrrrrrrrrrrrrrrrrrrrrrrrrMMrrrrrrrrrrrrrrrrrrrrrrrrMMMaaa
aaaMMMMMMMMMMrrrrMMrrrrrrrrrrrrrrrrrrrrrrrrrrrrrMMrrrrrrrrrrrrrrrrrrrrrrrrMMMaaa
aaaMMMrrrrrMMrrrrMMrrrrrrrrrrrrrrrrrrrrrrrrrrrrrMMrrrrrrrrrrrrrrrrrrrrrrrrMMMaaa
aaaMMMrrrrrMMrrrrMMrrrrrrrrrrrrrrrrrrrrrrrrrrrrrMMrrrrrrrrrrrrrrrrrrrrrrrrMMMaaa
aaaMMMrrrrrrrrrrrMMrrrrrrrrrrrrrrrrrrrrrrrrrrrrrMMrrrrrrrrrrrrrrrrrrrrrrrrMMMaaa
aaaMMMMMMMMMMrrrrMMrrrrrrrrrrrrrrrrrrrrrrrrrrrrrMMrrrrrrrrrrrrrrrrrrrrrrrrMMMaaa
aaaMMMMMMMMMMrrrrMMrrrrrrrrrrrrrrrrrrrrrrrrrrrrrMMrrrrrrrrrrrrrrrrrrrrrrrrMMMaaa
aaaMMMrrrrrMMrrrrMMrrrrrrrrrrrrrrrrrrrrrrrrrrrrrMMrrrrrrrrrrrrrrrrrrrrrrrrMMMaaa
aaaMMMrrrrrrrrrrrMMrrrrrrrrrrrrrrrrrrrrrrrrrrrrrMMrrrrrrrrrrrrrrrrrrrrrrrrMMMaaa
aaaMMMrrrrrMMrrrrMMrrrrrrrrrrrrrrrrrrrrrrrrrrrrrMMrrrrrrrrrrrrrrrrrrrrrrrrMMMaaa
aaaMMMrrrrrMMrrrrMMrrrrrrrrrrrrrrrrrrrrrrrrrrrrrMMrrrrrrrrrrrrrrrrrrrrrrrrMMMaaa
aaaMMMMMMMMMMrMMMMMMMMMMMMrrrrrrrrrrrrrrrrrrrrrrMMMrMMMMMMMMMMMMMMMrrrrrrrMMMaaa
aaaMMMMMMMMMMrMMMMMMMMMMMMrrrrrrrrrrrrrrrrrrrrrrMMMrMMMMMMMMMMMMMMMrrrrrrrMMMaaa
aaaMMMrrrrrrrrrrrrrrrrrrrrrrrrrrrrrrrrrrrrrrrrrrMMrrrrrrrrrrrrrrrMMrrrrrrrMMMaaa
aaaMMMMMMrMMMMMMMMMMMMMMMMrrrrrrrrrrrrrrrrrrrrrrMMrrrrrrrrrrrrrrrMMrrrrrrrMMMaaa
aaaMMMMMMrMMMMMMMMMMMMMMMMrrrrrrrrrrrrrrrrrrrrrrMMrrrrrrrrrrrrrrrMMrrrrrrrMMMaaa
aaaMMMMMMrMMMMMrrrrrrrrrMMrrrrrrrrrrrrrrrrrrrrrrMMrrrrrrrrrrrrrrrMMrrrrrrrMMMaaa
aaaMMMMMMrMMMMMrrrrrrrrrMMrrrrrrrrrrrrrrrrrrrrrrMMrrrrrrrrrrrrrrrMMrrrrrrrMMMaaa
aaaMMMMrrrrMMMMrrrrrrrrrrrrrrrrrrrrrrrrrrrrrrrrrMMrrrrrrrrrrrrrrrMMrrrrrrrMMMaaa
aaaMMMMrrrrMMMMrrrrrrrrrMMrrrrrrrrrrrrrrrrrrrrrrMMrrrrrrrrrrrrrrrMMrrrrrrrMMMaaa
aaaMMMMrrrrMMMMrrrrrrrrrMMrrrrrrrrrrrrrrrrrrrrrrMMrrrrrrrrrrrrrrrMMrrrrrrrMMMaaa
aaaMMMMrrrrMMMMrrrrrrrrrMMrrrrrrrrrrrrrrrrrrrrrrMMrrrrrrrrrrrrrrrMMrrrrrrrMMMaaa
aaaMMMMMMMMMMMMrrrrrrrrrMMrrrrrrrrrrrrrrrrrrrrrrMMrrrrrrrrrrrrrrrMMrrrrrrrMMMaaa
aaaMMMMMMMMMMMMMMMMMMMMMMMMMMMMMMMMMMMMMMMMMMMMMMMMMMMMMMMMMMMMMMMMMMMMMMMMMMaaa
aaaMMMMMMMMMMMMMMMMMMMMMMMMMMMMMMMMMMMMMMMMMMMMMMMMMMMMMMMMMMMMMMMMMMMMMMMMMMaaa
aaaMMMMMMMMMMMMMMMMMMMMMMMMMMMMMMMMMMMMMMMMMMMMMMMMMMMMMMMMMMMMMMMMMMMMMMMMMMaaa
aaaaaaaaaaaaaaaaaaaaaaaaaaaaaaaaaaaaaaaaaaaaaaaaaaaaaaaaaaaaaaaaaaaaaaaaaaaaaaaa
aaaaaaaaaaaaaaaaaaaaaaaaaaaaaaaaaaaaaaaaaaaaaaaaaaaaaaaaaaaaaaaaaaaaaaaaaaaaaaaa
aaaaaaaaaaaaaaaaaaaaaaaaaaaaaaaaaaaaaaaaaaaaaaaaaaaaaaaaaaaaaaaaaaaaaaaaaaaaaaaa
aaaaaaaaaaaaaaaaaaaaaaaaaaaaaaaaaaaaaaaaaaaaaaaaaaaaaaaaaaaaaaaaaaaaaaaaaaaaaaaa
"}
