"a" = (/turf/space/sky,/area/space)
"d" = (/turf/simulated/floor/plating,/area/space)
"V" = (/turf/simulated/wall/r_wall/prepainted,/area/space)

(1,1,1) = {"
aaaaaaaaaaaaaaaaaaaaaaaaaaaaaaaaaaaaaaaaaaaaaaaaaaaaaaaaaaaaaaaaaaaaaaaaaaaaaaaa
aaaaaaaaaaaaaaaaaaaaaaaaaaaaaaaaaaaaaaaaaaaaaaaaaaaaaaaaaaaaaaaaaaaaaaaaaaaaaaaa
aaaaaaaaaaaaaaaaaaaaaaaaaaaaaaaaaaaaaaaaaaaaaaaaaaaaaaaaaaaaaaaaaaaaaaaaaaaaaaaa
aaaVVVVVVVVVVVVVVVVVVVVVVVVVVVVVVVVVVVVVVVVVVVVVVVVVVVVVVVVVVVVVVVVVVVVVVVVVVaaa
aaaVVVVVVVVVVVVVVVVVVVVVVVVVVVVVVVVVVVVVVVVVVVVVVVVVVVVVVVVVVVVVVVVVVVVVVVVVVaaa
aaaVVVVVVVVVVVVVVVVVVVVVVVVVVVVVVVVVVVVVVVVVVVVVVVVVVVVVVVVVVVVVVVVVVVVVVVVVVaaa
aaaVVVddddddddddddddddddddddddddddddddddddddddddddddddddddddddddddddddddddVVVaaa
aaaVVVddddddddddddddddddddddddddddddddddddddddddddddddddddddddddddddddddddVVVaaa
aaaVVVddddddddddddddddddddddddddddddddddddddddddddddddddddddddddddddddddddVVVaaa
aaaVVVddddddddddddddddddddddddddddddddddddddddddddddddddddddddddddddddddddVVVaaa
aaaVVVddddddddddddddddddddddddddddddddddddddddddddddddddddddddddddddddddddVVVaaa
aaaVVVddddddddddddddddddddddddddddddddddddddddddddddddddddddddddddddddddddVVVaaa
aaaVVVddddddddddddddddddddddddddddddddddddddddddddddddddddddddddddddddddddVVVaaa
aaaVVVddddddddddddddddddddddddddddddddddddddddddddddddddddddddddddddddddddVVVaaa
aaaVVVddddddddddddddddddddddddddddddddddddddddddddddddddddddddddddddddddddVVVaaa
aaaVVVddddddddddddddddddddddddddddddddddddddddddddddddddddddddddddddddddddVVVaaa
aaaVVVddddddddddddddddddddddddddddddddddddddddddddddddddddddddddddddddddddVVVaaa
aaaVVVddddddddddddddddddddddddddddddddddddddddddddddddddddddddddddddddddddVVVaaa
aaaVVVddddddddddddddddddddddddddddddddddddddddddddddddddddddddddddddddddddVVVaaa
aaaVVVddddddddddddddddddddddddddddddddddddddddddddddddddddddddddddddddddddVVVaaa
aaaVVVddddddddddddddddddddddddddddddddddddddddddddddddddddddddddddddddddddVVVaaa
aaaVVVddddddddddddddddddddddddddddddddddddddddddddddddddddddddddddddddddddVVVaaa
aaaVVVddddddddddddddddddddddddddddddddddddddddddddddddddddddddddddddddddddVVVaaa
aaaVVVddddddddddddddddddddddddddddddddddddddddddddddddddddddddddddddddddddVVVaaa
aaaVVVddddddddddddddddddddddddddddddddddddddddddddddddddddddddddddddddddddVVVaaa
aaaVVVddddddddddddddddddddddddddddddddddddddddddddddddddddddddddddddddddddVVVaaa
aaaVVVddddddddddddddddddddddddddddddddddddddddddddddddddddddddddddddddddddVVVaaa
aaaVVVddddddddddddddddddddddddddddddddddddddddddddddddddddddddddddddddddddVVVaaa
aaaVVVddddddddddddddddddddddddddddddddddddddddddddddddddddddddddddddddddddVVVaaa
aaaVVVddddddddddddddddddddddddddddddddddddddddddddddddddddddddddddddddddddVVVaaa
aaaVVVddddddddddddddddddddddddddddddddddddddddddddddddddddddddddddddddddddVVVaaa
aaaVVVddddddddddddddddddddddddddddddddddddddddddddddddddddddddddddddddddddVVVaaa
aaaVVVddddddddddddddddddddddddddddddddddddddddddddddddddddddddddddddddddddVVVaaa
aaaVVVddddddddddddddddddddddddddddddddddddddddddddddddddddddddddddddddddddVVVaaa
aaaVVVddddddddddddddddddddddddddddddddddddddddddddddddddddddddddddddddddddVVVaaa
aaaVVVddddddddddddddddddddddddddddddddddddddddddddddddddddddddddddddddddddVVVaaa
aaaVVVddddddddddddddddddddddddddddddddddddddddddddddddddddddddddddddddddddVVVaaa
aaaVVVddddddddddddddddddddddddddddddddddddddddddddddddddddddddddddddddddddVVVaaa
aaaVVVddddddddddddddddddddddddddddddddddddddddddddddddddddddddddddddddddddVVVaaa
aaaVVVddddddddddddddddddddddddddddddddddddddddddddddddddddddddddddddddddddVVVaaa
aaaVVVddddddddddddddddddddddddddddddddddddddddddddddddddddddddddddddddddddVVVaaa
aaaVVVddddddddddddddddddddddddddddddddddddddddddddddddddddddddddddddddddddVVVaaa
aaaVVVddddddddddddddddddddddddddddddddddddddddddddddddddddddddddddddddddddVVVaaa
aaaVVVddddddddddddddddddddddddddddddddddddddddddddddddddddddddddddddddddddVVVaaa
aaaVVVddddddddddddddddddddddddddddddddddddddddddddddddddddddddddddddddddddVVVaaa
aaaVVVddddddddddddddddddddddddddddddddddddddddddddddddddddddddddddddddddddVVVaaa
aaaVVVddddddddddddddddddddddddddddddddddddddddddddddddddddddddddddddddddddVVVaaa
aaaVVVddddddddddddddddddddddddddddddddddddddddddddddddddddddddddddddddddddVVVaaa
aaaVVVddddddddddddddddddddddddddddddddddddddddddddddddddddddddddddddddddddVVVaaa
aaaVVVddddddddddddddddddddddddddddddddddddddddddddddddddddddddddddddddddddVVVaaa
aaaVVVddddddddddddddddddddddddddddddddddddddddddddddddddddddddddddddddddddVVVaaa
aaaVVVddddddddddddddddddddddddddddddddddddddddddddddddddddddddddddddddddddVVVaaa
aaaVVVddddddddddddddddddddddddddddddddddddddddddddddddddddddddddddddddddddVVVaaa
aaaVVVddddddddddddddddddddddddddddddddddddddddddddddddddddddddddddddddddddVVVaaa
aaaVVVddddddddddddddddddddddddddddddddddddddddddddddddddddddddddddddddddddVVVaaa
aaaVVVddddddddddddddddddddddddddddddddddddddddddddddddddddddddddddddddddddVVVaaa
aaaVVVddddddddddddddddddddddddddddddddddddddddddddddddddddddddddddddddddddVVVaaa
aaaVVVddddddddddddddddddddddddddddddddddddddddddddddddddddddddddddddddddddVVVaaa
aaaVVVddddddddddddddddddddddddddddddddddddddddddddddddddddddddddddddddddddVVVaaa
aaaVVVddddddddddddddddddddddddddddddddddddddddddddddddddddddddddddddddddddVVVaaa
aaaVVVddddddddddddddddddddddddddddddddddddddddddddddddddddddddddddddddddddVVVaaa
aaaVVVddddddddddddddddddddddddddddddddddddddddddddddddddddddddddddddddddddVVVaaa
aaaVVVddddddddddddddddddddddddddddddddddddddddddddddddddddddddddddddddddddVVVaaa
aaaVVVddddddddddddddddddddddddddddddddddddddddddddddddddddddddddddddddddddVVVaaa
aaaVVVVVVVVVVVVdddddddddddddddddddddddddddddddddddddddddddddddddddddddddddVVVaaa
aaaVVVVVVVVVVVVdddddddddddddddddddddddddddddddddddddddddddddddddddddddddddVVVaaa
aaaVVVVVVVVVVVVdddddddddddddddddddddddddddddddddddddddddddddddddddddddddddVVVaaa
aaaVVVVVVVVVVVVdddddddddddddddddddddddddddddddddddddddddddddddddddddddddddVVVaaa
aaaVVVVddddVVVVdddddddddddddddddddddddddddddddddddddddddddddddddddddddddddVVVaaa
aaaVVVVddddVVVVdddddddddddddddddddddddddddddddddddddddddddddddddddddddddddVVVaaa
aaaVVVVddddVVVVdddddddddddddddddddddddddddddddddddddddddddddddddddddddddddVVVaaa
aaaVVVVddddVVVVdddddddddddddddddddddddddddddddddddddddddddddddddddddddddddVVVaaa
aaaVVVVVVVVVVVVdddddddddddddddddddddddddddddddddddddddddddddddddddddddddddVVVaaa
aaaVVVVVVVVVVVVVVVVVVVVVVVVVVVVVVVVVVVVVVVVVVVVVVVVVVVVVVVVVVVVVVVVVVVVVVVVVVaaa
aaaVVVVVVVVVVVVVVVVVVVVVVVVVVVVVVVVVVVVVVVVVVVVVVVVVVVVVVVVVVVVVVVVVVVVVVVVVVaaa
aaaVVVVVVVVVVVVVVVVVVVVVVVVVVVVVVVVVVVVVVVVVVVVVVVVVVVVVVVVVVVVVVVVVVVVVVVVVVaaa
aaaaaaaaaaaaaaaaaaaaaaaaaaaaaaaaaaaaaaaaaaaaaaaaaaaaaaaaaaaaaaaaaaaaaaaaaaaaaaaa
aaaaaaaaaaaaaaaaaaaaaaaaaaaaaaaaaaaaaaaaaaaaaaaaaaaaaaaaaaaaaaaaaaaaaaaaaaaaaaaa
aaaaaaaaaaaaaaaaaaaaaaaaaaaaaaaaaaaaaaaaaaaaaaaaaaaaaaaaaaaaaaaaaaaaaaaaaaaaaaaa
aaaaaaaaaaaaaaaaaaaaaaaaaaaaaaaaaaaaaaaaaaaaaaaaaaaaaaaaaaaaaaaaaaaaaaaaaaaaaaaa
"}
