"a" = (/turf/space/sky,/area/space)
"k" = (/turf/simulated/floor/tiled/techfloor/grid,/area/space)
"o" = (/obj/effect/floor_decal/industrial/outline/yellow,/turf/simulated/floor/tiled/techfloor/grid,/area/space)
"q" = (/turf/simulated/floor/tiled/dark/monotile,/area/space)
"A" = (/turf/simulated/wall/titanium,/area/space)
"D" = (/turf/simulated/wall/r_wall/prepainted,/area/space)
"M" = (/turf/simulated/floor/tiled/techfloor,/area/space)
"X" = (/turf/simulated/floor/plating,/area/space)

(1,1,1) = {"
aaaaaaaaaaaaaaaaaaaaaaaaaaaaaaaaaaaaaaaaaaaaaaaaaaaaaaaaaaaaaaaaaaaaaaaaaaaaaaaa
aaaaaaaaaaaaaaaaaaaaaaaaaaaaaaaaaaaaaaaaaaaaaaaaaaaaaaaaaaaaaaaaaaaaaaaaaaaaaaaa
aaaaaaaaaaaaaaaaaaaaaaaaaaaaaaaaaaaaaaaaaaaaaaaaaaaaaaaaaaaaaaaaaaaaaaaaaaaaaaaa
aaaaaaaaaaaaaaaaaaaaaaaaaaaaaaaaaaaaaaaaaaaaaaaaaaaaaaaaaaaaaaaaaaaaaaaaaaaaaaaa
aaaaaaaaaaaaaaaaaaaaaaaaaaaaaaaaaaaaaaaaaaaaaaaaaaaaaaaaaaaaaaaaaaaaaaaaaaaaaaaa
aaaaaaaaaaaaaaaaaaaaaaaaaaaaaaaaaaaaaaaaaaaaaaaaaaaaaaaaaaaaaaaaaaaaaaaaaaaaaaaa
aaaaaaaaaaaaaaaaaaaaaaaaaaaaaaaaaaaaaaaaaaaaaaaaaaaaaaaaaaaaaaaaaaaaaaaaaaaaaaaa
aaaaaaaaaaaaaaaaaaaaaaaaaaaaaaaaaaaaaaaaaaaaaaaaaaaaaaaaaaaaaaaaaaaaaaaaaaaaaaaa
aaaaaaaaaaaaaaaaaaaaaaaaaaaaaaaaaaaaaaaaaaaaaaaaaaaaaaaaaaaaaaaaaaaaaaaaaaaaaaaa
aaaaaaaaaaaaaaaaaaaaaaaaaaaaaaaaaaaaaaaaaaaaaaaaaaaaaaaaaaaaaaaaaaaaaaaaaaaaaaaa
aaaaaaaaaaaaaaaaaaaaaaaaaaaaaaaaaaaaaaaaaaaaaaaaaaaaaaaaaaaaaaaaaaaaaaaaaaaaaaaa
aaaaaaaaaaaaaaaaaaaaaaaaaaaaaaaaaaaaaaaaaaaaaaaaaaaaaaaaaaaaaaaaaaaaaaaaaaaaaaaa
aaaaaaaaaaaaaaaaaaaaaaaaaaaaaaaaaaaaaaaaaaaaaaaaaaaaaaaaaaaaaaaaaaaaaaaaaaaaaaaa
aaaaaaaaaaaaaaaaaaaaaaaaaaaaaaaaaaaaaaaaaaaaaaaaaaaaaaaaaaaaaaaaaaaaaaaaaaaaaaaa
aaaaaaaaaaaaaaaaaaaaaaaaaaaaaaaaaaaaaaaaaaaaaaaaaaaaaaaaaaaaaaaaaaaaaaaaaaaaaaaa
aaaaaaaaaaaaaaaaaaaaaaaaaaaaaaaaaaaaaaaaaaaaaaaaaaaaaaaaaaaaaaaaaaaaaaaaaaaaaaaa
aaaaaaaaaaaaaaaaaaaaaaaaaaaaaaaaaaaaaaaaaaaaaaaaaaaaaaaaaaaaaaaaaaaaaaaaaaaaaaaa
aaaaaaaaaaaaaaaaaaaaaaaaaaaaaaaaaaaaaaaaaaaaaaaaaaaaaaaaaaaaaaaaaaaaaaaaaaaaaaaa
aaaaaaaaaaaaaaaaaaaaaaaaaaaaaaaaaaaaaaaaaaaaaaaaaaaaaaaaaaaaaaaaaaaaaaaaaaaaaaaa
aaaaaaaaaaaaaaaaaaaaaaaaaaaaaaaaaaaaaaaaaaaaaaaaaaaaaaaaaaaaaaaaaaaaaaaaaaaaaaaa
aaaaaaaaaaaaaaaaaaaaaaaaaaaaaaaaaaaaaaaaaaaaaaaaaaaaaaaaaaaaaaaaaaaaaaaaaaaaaaaa
aaaaaaaaaaaaaaaaaaaaaaaaaaaaaaaaaaaaaaaaaaaaaaaaaaaaaaaaaaaaaaaaaaaaaaaaaaaaaaaa
aaaaaaaaaaaaaaaaaaaaaaaaaaaaaaaaaaaaaaaaaaaaaaaaaaaaaaaaaaaaaaaaaaaaaaaaaaaaaaaa
aaaaaaaaaaaaaaaaaaaaaaaaaaaaaaaaaaaaaaaaaaaaaaaaaaaaaaaaaaaaaaaaaaaaaaaaaaaaaaaa
aaaaaaaaaaaaaaaaaaaaaaaaaaaaaaaaaaaaaaaaaaaaaaaaaaaaaaaaaaaaaaaaaaaaaaaaaaaaaaaa
aaaaaaaaaaaaaaaaaaaaaaaaaaaaaaaaaaaaaaaaaaaaaaaaaaaaaaaaaaaaaaaaaaaaaaaaaaaaaaaa
aaaaaaaaaaaaaaaaaaaaaaaaaaaaaaaaaaaaaaaaaaaaaaaaaaaaaaaaaaaaaaaaaaaaaaaaaaaaaaaa
aaaaaaaaaaaaaaaaaaaaaaaaaaaaaaaaaaaaaaaaaaaaaaaaaaaaaaaaaaaaaaaaaaaaaaaaaaaaaaaa
aaaaaaaaaaaaaaaaaaaaaaaaaaaaaaaaDDDDDDDDDDDDDDDaaaaaaaaaaaaaaaaaaaaaaaaaaaaaaaaa
aaaaaaaaaaaaaaaaaaaaaaaaDDDDDDDDDDDDDDDDDDDDDDDDDDDDDDDaaaaaaaaaaaaaaaaaaaaaaaaa
aaaaaaaaaaaaaaaaaaaaaaaaDDDDDDDDDDXXXXXXXXXXXDDDDDDDDDDaaaaaaaaaaaaaaaaaaaaaaaaa
aaaaaaaaaaaaaaaaaaaaaaaaDDXXXXXXXDXXXXXXXXXXXDXXXXXXXDDaaaaaaaaaaaaaaaaaaaaaaaaa
aaaaaaaaaaaaaaaaaaaaaaaaDDXXXXXXXDXXXXXXXXXXXDXXXXXXXDDaaaaaaaaaaaaaaaaaaaaaaaaa
aaaaaaaaaaaaaaaaaaaaaaaaDDXXXXXXXDXXXXXXXXXXXDXXXXXXXDDaaaaaaaaaaaaaaaaaaaaaaaaa
aaaaaaaaaaaaaaaaaaaaaaaaDDXXXXXXXDDDDDDkDDDDDDXXXXXXXDDaaaaaaaaaaaaaaaaaaaaaaaaa
aaaaaaaaaaaaaaaaaDDDDDDDDDXXXXXXXDXXXXXXXXXXXDXXXXXXXDDDDDDDDDaaaaaaaaaaaaaaaaaa
aaaaaaaaaaaaaaaaaDDDDDDDDDXXXXXXXDXDDDDDDDDDXDXXXXXXXDDDDDDDDDaaaaaaaaaaaaaaaaaa
aaaaaaaaaaaaaaaaaDDXXXXXXDDDDkDDDDXDXXXXXXXDXDDDDkDDDDXXXXXXDDaaaaaaaaaaaaaaaaaa
aaaaaAAAXXXAAAaaaDDDDkDDXkXXXXXXXkXDXXXXXXXDXkXXXXXXXkXDDDDDDDaaaaaaaaaaaaaaaaaa
aaaaAAXAXXXAXAAaaaXXXXXDDDDDDDDDDDDDXXXXXXXDDDDDDDDDDDDDXXXXXaaaaaaaaaaaaaaaaaaa
aaaaAXXAXXXAXXAaaaXXXXXDMoMoMoMoMoMDXXXXXXXDMoMoMoMoMoMDXXXXXaaaaaaaaaaaaaaaaaaa
aaaaXXXAXXXAXXXaaaXXXXXDMoMoMoMoMoMDXXXXXXXDMoMoMoMoMoMDXXXXXaaaaaaaaaaaaaaaaaaa
aaaaXXXAAXAAXXXaaaDDDkDDMMMMMMMMMMMDXXXXXXXDMMMMMMMMMMMDDkDDDaaaaaaaaaaaaaaaaaaa
aaaaAXXXXXXXXXAaaaDqqqqDMoMoMoMoMoMDXXXXXXXDMoMoMoMoMoMDXXXXDaaaaaaaaaaaaaaaaaaa
aaaaAAAAAXAAAAADDDDqqqqDMoMoMoMoMoMDDDXXXDDDMoMoMoMoMoMDXXXXDDDDaaaaaaaaaaaaaaaa
aaaaAXXAXXXkMMkkMMkqqqqDDDkDDDDDkDDDqqqqqqqDDDkDDDDDkDDDXXXXkXXkaaaaaaaaaaaaaaaa
aaaaAXXXXXXkMMkkMMkqqqqkqqqqqkqqqqqkqqqqqqqkqqqqqkqqqqqkXXXXkXXkaaaaaaaaaaaaaaaa
aaaaAXXAXXXkMMkkMMkqqqqDDDkDDDDDkDDDqqqqqqqDDDkDDDDDkDDDXXXXkXXkaaaaaaaaaaaaaaaa
aaaaAAAAAXAAAAADDDDqqqqDMoMoMoMoMoMDDDDkDDDDMoMoMoMoMoMDXXXXDDDDaaaaaaaaaaaaaaaa
aaaaAXXAXXXAXXAaaaDqqqqDMoMoMoMoMoMDXXXXXXXDMoMoMoMoMoMDXXXXDaaaaaaaaaaaaaaaaaaa
aaaaXXXAXXXAXXXaaaDDDkDDMMMMMMMMMMMDXXXXXXXDMMMMMMMMMMMDDkDDDaaaaaaaaaaaaaaaaaaa
aaaaXXXXXXXXXXXaaaXXXXXDMoMoMoMoMoMDXXXXXXXDMoMoMoMoMoMDXXXXXaaaaaaaaaaaaaaaaaaa
aaaaAXXAXXXAXXAaaaXXXXXDMoMoMoMoMoMDXXXXXXXDMoMoMoMoMoMDXXXXXaaaaaaaaaaaaaaaaaaa
aaaaAAXAXXXAXAAaaaXXXXXDDDDDDDDDDDDDXXXXXXXDDDDDDDDDDDDDXXXXXaaaaaaaaaaaaaaaaaaa
aaaaaAAAAAAAAAaaaDDDDkDDXkXXXXXXXkXkXXXXXXXkXkXXXXXXXkXDDDDDDDaaaaaaaaaaaaaaaaaa
aaaaaaaaaaaaaaaaaDDXXXXXXDDDDkDDDDXDXXXXXXXDXDDDDkDDDDXXXXXXDDaaaaaaaaaaaaaaaaaa
aaaaaaaaaaaaaaaaaDDDDDDDDDXXXXXXXDXDDDDkDDDDXDXXXXXXXDDDDDDDDDaaaaaaaaaaaaaaaaaa
aaaaaaaaaaaaaaaaaDDDDDDDDDXXXXXXXDXkXXXXXXXkXDXXXXXXXDDDDDDDDDaaaaaaaaaaaaaaaaaa
aaaaaaaaaaaaaaaaaaaaaaaaDDXXXXXXXDDDDDDkDDDDDDXXXXXXXDDaaaaaaaaaaaaaaaaaaaaaaaaa
aaaaaaaaaaaaaaaaaaaaaaaaDDXXXXXXXDXXXXXXXXXXXDXXXXXXXDDaaaaaaaaaaaaaaaaaaaaaaaaa
aaaaaaaaaaaaaaaaaaaaaaaaDDXXXXXXXDXXXXXXXXXXXDXXXXXXXDDaaaaaaaaaaaaaaaaaaaaaaaaa
aaaaaaaaaaaaaaaaaaaaaaaaDDXXXXXXXDXXXXXXXXXXXDXXXXXXXDDaaaaaaaaaaaaaaaaaaaaaaaaa
aaaaaaaaaaaaaaaaaaaaaaaaDDDDDDDDDDXXXXXXXXXXXDDDDDDDDDDaaaaaaaaaaaaaaaaaaaaaaaaa
aaaaaaaaaaaaaaaaaaaaaaaaDDDDDDDDDDDDDDDDDDDDDDDDDDDDDDDaaaaaaaaaaaaaaaaaaaaaaaaa
aaaaaaaaaaaaaaaaaaaaaaaaaaaaaaaaDDDDDDDDDDDDDDDaaaaaaaaaaaaaaaaaaaaaaaaaaaaaaaaa
aaaaaaaaaaaaaaaaaaaaaaaaaaaaaaaaaaaaaaaaaaaaaaaaaaaaaaaaaaaaaaaaaaaaaaaaaaaaaaaa
aaaaaaaaaaaaaaaaaaaaaaaaaaaaaaaaaaaaaaaaaaaaaaaaaaaaaaaaaaaaaaaaaaaaaaaaaaaaaaaa
aaaaaaaaaaaaaaaaaaaaaaaaaaaaaaaaaaaaaaaaaaaaaaaaaaaaaaaaaaaaaaaaaaaaaaaaaaaaaaaa
aaaaaaaaaaaaaaaaaaaaaaaaaaaaaaaaaaaaaaaaaaaaaaaaaaaaaaaaaaaaaaaaaaaaaaaaaaaaaaaa
aaaaaaaaaaaaaaaaaaaaaaaaaaaaaaaaaaaaaaaaaaaaaaaaaaaaaaaaaaaaaaaaaaaaaaaaaaaaaaaa
aaaaaaaaaaaaaaaaaaaaaaaaaaaaaaaaaaaaaaaaaaaaaaaaaaaaaaaaaaaaaaaaaaaaaaaaaaaaaaaa
aaaaaaaaaaaaaaaaaaaaaaaaaaaaaaaaaaaaaaaaaaaaaaaaaaaaaaaaaaaaaaaaaaaaaaaaaaaaaaaa
aaaaaaaaaaaaaaaaaaaaaaaaaaaaaaaaaaaaaaaaaaaaaaaaaaaaaaaaaaaaaaaaaaaaaaaaaaaaaaaa
aaaaaaaaaaaaaaaaaaaaaaaaaaaaaaaaaaaaaaaaaaaaaaaaaaaaaaaaaaaaaaaaaaaaaaaaaaaaaaaa
aaaaaaaaaaaaaaaaaaaaaaaaaaaaaaaaaaaaaaaaaaaaaaaaaaaaaaaaaaaaaaaaaaaaaaaaaaaaaaaa
aaaaaaaaaaaaaaaaaaaaaaaaaaaaaaaaaaaaaaaaaaaaaaaaaaaaaaaaaaaaaaaaaaaaaaaaaaaaaaaa
aaaaaaaaaaaaaaaaaaaaaaaaaaaaaaaaaaaaaaaaaaaaaaaaaaaaaaaaaaaaaaaaaaaaaaaaaaaaaaaa
aaaaaaaaaaaaaaaaaaaaaaaaaaaaaaaaaaaaaaaaaaaaaaaaaaaaaaaaaaaaaaaaaaaaaaaaaaaaaaaa
aaaaaaaaaaaaaaaaaaaaaaaaaaaaaaaaaaaaaaaaaaaaaaaaaaaaaaaaaaaaaaaaaaaaaaaaaaaaaaaa
aaaaaaaaaaaaaaaaaaaaaaaaaaaaaaaaaaaaaaaaaaaaaaaaaaaaaaaaaaaaaaaaaaaaaaaaaaaaaaaa
"}
